season,Entry.Player,Position,Team(s),Minutes on Ice,GP,G,A,P,P_60
20182019,A.J. Greer,Left Wing,COL,126.2,15,1,1,2,0.950871632
20182019,Aaron Ekblad,Defense,FLA,1917.633333,82,13,24,37,1.157676998
20182019,Adam Clendening,Defense,CBJ,79.66666667,4,0,0,0,0
20182019,Adam Cracknell,Right Wing,ANA,38.55,2,0,0,0,0
20182019,Adam Erne,Left Wing,TBL,232.7333333,65,7,13,20,5.156115726
20182019,Adam Gaudette,Center,VAN,64.73333333,56,5,7,12,11.12255407
20182019,Adam Henrique,Center,ANA,1441.783333,82,18,24,42,1.747835435
20182019,Adam Johnson,Left Wing,PIT,28.26666667,6,0,2,2,4.245283019
20182019,Adam Larsson,Defense,EDM,1380.516667,82,3,17,20,0.869239777
20182019,Adam Lowry,Left Wing,WPG,669.25,78,12,11,23,2.062009712
20182019,Adam McQuaid,Defense,NYR/CBJ,596.5666667,50,3,4,7,0.704028608
20182019,Adam Pelech,Defense,NYI,1503.9,78,5,16,21,0.837821664
20182019,Adrian Kempe,Center,LAK,1081.25,81,12,16,28,1.553757225
20182019,Alan Quine,Center,CGY,246.45,13,3,2,5,1.217285453
20182019,Alec Martinez,Defense,LAK,1757.933333,60,4,14,18,0.614357769
20182019,Aleksander Barkov,Center,FLA,1743.133333,82,35,61,96,3.304394386
20182019,Alex Biega,Defense,VAN,662.2,41,2,14,16,1.449713078
20182019,Alex Chiasson,Right Wing,EDM,718.05,73,22,16,38,3.175266346
20182019,Alex DeBrincat,Center,CHI,1212.333333,82,41,35,76,3.761341765
20182019,Alex Formenton,Left Wing,OTT,4.9,9,1,0,1,12.24489796
20182019,Alex Galchenyuk,Center,ARI,1331.233333,72,19,22,41,1.847910459
20182019,Alex Goligoski,Defense,ARI,1816.233333,76,3,24,27,0.891955879
20182019,Alex Iafallo,Center,LAK,1131.566667,82,15,18,33,1.749786432
20182019,Alex Killorn,Center,TBL,1352.433333,82,18,22,40,1.774579154
20182019,Alex Ovechkin,Right Wing,WSH,1650.25,81,51,38,89,3.235873353
20182019,Alex Petrovic,Defense,FLA/EDM,982.1,35,0,2,2,0.12218715
20182019,Alex Pietrangelo,Defense,STL,2007.783333,71,13,28,41,1.225231806
20182019,Alex Tuch,Center,VGK,1187.6,74,20,32,52,2.627147188
20182019,Alexander Edler,Defense,VAN,1698.233333,56,10,24,34,1.201248356
20182019,Alexander Kerfoot,Center,COL,1059.1,78,15,27,42,2.379378718
20182019,Alexander Nylander,Left Wing,BUF,38.58333333,12,2,2,4,6.220302376
20182019,Alexander Radulov,Right Wing,DAL,1647.3,70,29,43,72,2.622473138
20182019,Alexander Steen,Left Wing,STL,1420.783333,65,10,17,27,1.140216078
20182019,Alexander Wennberg,Center,CBJ,1196.666667,75,2,23,25,1.253481894
20182019,Alexandre Fortin,Left Wing,CHI,254.1833333,24,3,3,6,1.41630057
20182019,Anders Bjork,Left Wing,BOS,370.1166667,20,1,2,3,0.486333138
20182019,Anders Lee,Center,NYI,1415.8,82,28,23,51,2.161322221
20182019,Andre Burakovsky,Left Wing,WSH,772.6333333,76,12,13,25,1.941412485
20182019,Andreas Athanasiou,Center,DET,1088.716667,76,30,24,54,2.975980895
20182019,Andreas Englund,Defense,OTT,11.35,3,0,0,0,0
20182019,Andreas Johnsson,Left Wing,TOR,104.9333333,73,20,23,43,24.58703939
20182019,Andreas Martinsen,Left Wing,CHI,113.7666667,24,1,3,4,2.109581014
20182019,Andrei Svechnikov,Right Wing,CAR,1199.514222,82,20,17,37,1.850749211
20182019,Andrej Sekera,Defense,EDM,586.1166667,24,0,4,4,0.409474792
20182019,Andrej Sustr,Defense,ANA,565.5666667,5,0,0,0,0
20182019,Andrew Agozzino,Left Wing,COL,88.165,11,1,1,2,1.361084331
20182019,Andrew Cogliano,Center,ANA/DAL,1215.116667,78,6,11,17,0.83942557
20182019,Andrew Copp,Center,WPG,1125.416667,69,11,14,25,1.332839689
20182019,Andrew Ladd,Left Wing,NYI,1159.883333,26,3,8,11,0.569022747
20182019,Andrew MacDonald,Defense,PHI,1310.316667,47,0,9,9,0.41211412
20182019,Andrew Mangiapane,Left Wing,CGY,89.3,44,8,5,13,8.734602464
20182019,Andrew Shaw,Right Wing,MTL,806.2833333,63,19,28,47,3.497529818
20182019,Andy Greene,Defense,NJD,1711.016667,82,5,20,25,0.876671764
20182019,Andy Welinski,Defense,ANA,113.9333333,26,1,3,4,2.106495026
20182019,Anthony Beauvillier,Center,NYI,1031.983333,81,18,10,28,1.627933268
20182019,Anthony Bitetto,Defense,NSH/MIN,430.8,36,0,3,3,0.417827298
20182019,Anthony Cirelli,Center,TBL,238.1666667,82,19,20,39,9.825052484
20182019,Anthony DeAngelo,Defense,NYR,530.5166667,61,4,26,30,3.392918853
20182019,Anthony Duclair,Left Wing,CBJ/OTT,744.2,74,19,14,33,2.660575114
20182019,Anthony Greco,Right Wing,FLA,9.5,1,0,0,0,0
20182019,Anthony Mantha,Left Wing,DET,1381.033333,67,25,23,48,2.085394994
20182019,Anthony Peluso,Right Wing,CGY,9.283333333,4,0,0,0,0
20182019,Anthony Richard,Center,NSH,7.366666667,1,0,0,0,0
20182019,Antoine Roussel,Left Wing,VAN,906.1333333,65,9,22,31,2.052678046
20182019,Anton Blidh,Left Wing,BOS,10.38333333,1,0,0,0,0
20182019,Anton Lindholm,Defense,COL,632.4833333,2,0,0,0,0
20182019,Anton Stralman,Defense,TBL,1717.55,47,2,15,17,0.593869174
20182019,Antti Suomela,Center,SJS,305.5333333,27,3,5,8,1.571023347
20182019,Anze Kopitar,Center,LAK,1803.466667,81,22,38,60,1.996155552
20182019,Artem Anisimov,Center,CHI,1208.766667,78,15,22,37,1.836582743
20182019,Artemi Panarin,Left Wing,CBJ,1629.983333,79,28,59,87,3.202486733
20182019,Artturi Lehkonen,Left Wing,MTL,1088.166667,82,11,20,31,1.709296983
20182019,Ashton Sautner,Defense,VAN,66.8,17,0,1,1,0.898203593
20182019,Austin Czarnik,Center,CGY,109.1166667,54,6,12,18,9.897663052
20182019,Austin Wagner,Left Wing,LAK,547.4975758,62,12,9,21,2.301380053
20182019,Austin Watson,Center,NSH,937.3666667,37,7,9,16,1.024145656
20182019,Auston Matthews,Center,TOR,1123.25,68,37,36,73,3.899399065
20182019,Barclay Goodrow,Right Wing,SJS,510.5166667,82,7,10,17,1.997975907
20182019,Ben Chiarot,Defense,WPG,869.9833333,78,5,15,20,1.379336769
20182019,Ben Harpur,Defense,OTT,610.3333333,51,1,4,5,0.491534681
20182019,Ben Hutton,Defense,VAN,1122.983333,69,5,15,20,1.068582199
20182019,Ben Lovejoy,Defense,NJD/DAL,945.1333333,71,2,7,9,0.571347958
20182019,Ben Street,Center,ANA,254.1166667,21,3,2,5,1.18056011
20182019,Benjamin Gleason,Defense,DAL,59.51666667,4,0,1,1,1.008120975
20182019,Blake Coleman,Center,NJD,1137.483333,78,22,14,36,1.898928922
20182019,Blake Comeau,Left Wing,DAL,1253.483333,77,7,11,18,0.861599011
20182019,Blake Pietila,Left Wing,NJD,18.91666667,19,0,1,1,3.171806167
20182019,Blake Wheeler,Right Wing,WPG,1641.35,82,20,71,91,3.326529991
20182019,Bo Horvat,Center,VAN,1238.716667,82,27,34,61,2.954670829
20182019,Bobby Ryan,Right Wing,OTT,1019.216667,78,15,27,42,2.472487041
20182019,Bogdan Kiselevich,Defense,FLA,475.7333333,32,0,8,8,1.00896861
20182019,Boo Nieves,Center,NYR,285.5666667,43,4,6,10,2.101085561
20182019,Boone Jenner,Center,CBJ,1233.266667,77,16,22,38,1.848748581
20182019,Brad Hunt,Defense,VGK/MIN,751.3666667,42,5,7,12,0.958253849
20182019,Brad Malone,Center,EDM,55.91666667,16,0,0,0,0
20182019,Brad Marchand,Left Wing,BOS,1341.55,79,36,64,100,4.472438597
20182019,Brad Richardson,Right Wing,ARI,1122.683333,66,19,8,27,1.442971452
20182019,Brady Skjei,Defense,NYR,1721.516667,78,8,17,25,0.871324704
20182019,Brady Tkachuk,Left Wing,OTT,1111.982031,71,22,23,45,2.428096789
20182019,Brandon Carlo,Defense,BOS,1462.516667,72,2,8,10,0.410251735
20182019,Brandon Davidson,Defense,CHI,857.0333333,10,0,1,1,0.070008946
20182019,Brandon Dubinsky,Center,CBJ,951.85,61,6,8,14,0.882491989
20182019,Brandon Gignac,Center,NJD,9.066666667,1,0,0,0,0
20182019,Brandon Manning,Defense,CHI/EDM,1166.1,39,2,2,4,0.205814253
20182019,Brandon Montour,Defense,ANA/BUF,1636.433333,82,8,27,35,1.283278675
20182019,Brandon Pirri,Center,VGK,35.23333333,31,12,6,18,30.65279092
20182019,Brandon Saad,Left Wing,CHI,1435.366667,80,23,24,47,1.964654792
20182019,Brandon Sutter,Center,VAN,1055.2,26,4,2,6,0.341167551
20182019,Brandon Tanev,Center,WPG,772.3333333,80,14,15,29,2.25291325
20182019,Brayden McNabb,Defense,VGK,1533.183333,81,4,12,16,0.62614821
20182019,Brayden Point,Center,TBL,1608.85,79,41,51,92,3.431022159
20182019,Brayden Schenn,Center,STL,1614.933333,72,17,37,54,2.006274769
20182019,Braydon Coburn,Defense,TBL,1154.116667,74,4,19,23,1.19571967
20182019,Brendan Gallagher,Right Wing,MTL,1324.9,82,33,19,52,2.354894709
20182019,Brendan Gaunce,Left Wing,VAN,492.5,3,1,2,3,0.365482234
20182019,Brendan Guhle,Defense,BUF/ANA,325.45,8,0,1,1,0.184360117
20182019,Brendan Leipsic,Left Wing,VAN/LAK,759.8333333,62,7,16,23,1.81618776
20182019,Brendan Lemieux,Left Wing,WPG/NYR,71.46666667,63,12,5,17,14.27238806
20182019,Brendan Perlini,Left Wing,ARI/CHI,1073.5,68,14,7,21,1.173730787
20182019,Brendan Smith,Defense,NYR,756.15,63,4,9,13,1.031541361
20182019,Brenden Dillon,Defense,SJS,1402.266667,82,1,21,22,0.94133308
20182019,Brent Burns,Defense,SJS,2065.15,82,16,67,83,2.41144711
20182019,Brent Seabrook,Defense,CHI,1636.483333,78,5,23,28,1.026591573
20182019,Brett Connolly,Right Wing,WSH,837.9833333,81,22,24,46,3.293621592
20182019,Brett Howden,Center,NYR,980.1559322,66,6,17,23,1.407939242
20182019,Brett Kulak,Defense,MTL,923.2833333,57,6,11,17,1.104752965
20182019,Brett Pesce,Defense,CAR,1359.166667,73,7,22,29,1.280196199
20182019,Brett Ritchie,Right Wing,DAL,769.55,53,4,2,6,0.467805861
20182019,Brett Seney,Left Wing,NJD,527.612,51,5,8,13,1.478359097
20182019,Brian Boyle,Center,NJD/NSH,917.7666667,73,18,6,24,1.569026259
20182019,Brian Dumoulin,Defense,PIT,1649.85,76,3,20,23,0.836439676
20182019,Brian Gibbons,Center,ANA/OTT,851.75,64,8,11,19,1.338420898
20182019,Brian Lashoff,Defense,DET,4.033333333,4,0,1,1,14.87603306
20182019,Brock Boeser,Right Wing,VAN,1084.633333,69,26,30,56,3.097821076
20182019,Brock McGinn,Left Wing,CAR,1159.983333,82,10,16,26,1.344846909
20182019,Brock Nelson,Center,NYI,1206.9,82,25,28,53,2.634849615
20182019,Brooks Orpik,Defense,WSH,1567.383333,53,2,7,9,0.34452325
20182019,Bryan Little,Center,WPG,1388.133333,82,15,26,41,1.772164057
20182019,Bryan Rust,Right Wing,PIT,1107.383333,72,18,17,35,1.896362296
20182019,C.J. Smith,Right Wing,BUF,117.2,11,2,0,2,1.023890785
20182019,Cal Clutterbuck,Right Wing,NYI,971.5,73,8,15,23,1.420483788
20182019,Caleb Jones,Defense,EDM,336.8,17,1,5,6,1.06888361
20182019,Calle Jarnkrok,Center,NSH,1077.783333,79,10,16,26,1.44741522
20182019,Calle Rosen,Defense,TOR,51.15,4,1,0,1,1.173020528
20182019,Calvin De Haan,Defense,CAR,616.75,74,1,13,14,1.361978111
20182019,Cam Atkinson,Right Wing,CBJ,1229.216667,80,41,28,69,3.36799859
20182019,Cam Fowler,Defense,ANA,1664.05,59,5,18,23,0.829302004
20182019,Cameron Schilling,Defense,WPG,48.38333333,4,0,1,1,1.240096452
20182019,Carl Dahlstrom,Defense,CHI,191.9666667,38,0,6,6,1.875325577
20182019,Carl Grundstrom,Left Wing,LAK,212.21875,15,5,1,6,1.696362833
20182019,Carl Gunnarsson,Defense,STL,1019.433333,25,3,4,7,0.411993591
20182019,Carl Hagelin,Left Wing,PIT/LAK/WSH,1291.516667,58,5,14,19,0.88268315
20182019,Carl Soderberg,Center,COL,1334.566667,82,23,26,49,2.20296226
20182019,Carter Rowney,Right Wing,ANA,411.25,62,7,13,20,2.917933131
20182019,Casey Cizikas,Center,NYI,845.45,73,20,13,33,2.341948075
20182019,Casey Mittelstadt,Center,BUF,82.4,77,12,13,25,18.2038835
20182019,Casey Nelson,Defense,BUF,696.9833333,38,1,5,6,0.516511633
20182019,Cedric Paquette,Center,TBL,571.1666667,80,13,4,17,1.7858185
20182019,Chad Ruhwedel,Defense,PIT,692.15,18,1,1,2,0.173372824
20182019,Chandler Stephenson,Center,WSH,794.95,64,5,6,11,0.830240896
20182019,Charles Hudon,Left Wing,MTL,1010.083333,32,3,2,5,0.297005198
20182019,Charlie Coyle,Center,MIN/BOS,1089.116667,81,12,22,34,1.873077571
20182019,Charlie McAvoy,Defense,BOS,1393.033333,54,7,21,28,1.206001292
20182019,Chris Butler,Defense,STL,79.83333333,13,1,1,2,1.503131524
20182019,Chris Kreider,Left Wing,NYR,904.3666667,79,28,24,52,3.449928126
20182019,Chris Kunitz,Left Wing,CHI,980,56,5,5,10,0.612244898
20182019,Chris Thorburn,Right Wing,STL,351.8166667,1,0,0,0,0
20182019,Chris Tierney,Center,OTT,1309.883333,81,9,39,48,2.198669093
20182019,Chris Wagner,Right Wing,BOS,1049.066667,76,12,7,19,1.086680224
20182019,Chris Wideman,Defense,OTT/EDM/FLA,184.9333333,25,2,5,7,2.271088681
20182019,Christian Djoos,Defense,WSH,883.8,45,1,9,10,0.678886626
20182019,Christian Dvorak,Center,ARI,1278.75,20,2,5,7,0.328445748
20182019,Christian Fischer,Right Wing,ARI,1099.366667,71,11,7,18,0.982383797
20182019,Christian Folin,Defense,PHI/MTL,1016.616667,45,0,6,6,0.354115776
20182019,Christian Jaros,Defense,OTT,15.93333333,61,1,9,10,37.65690377
20182019,Christian Wolanin,Defense,OTT,146.4666667,30,4,8,12,4.915794265
20182019,Christoffer Ehn,Center,DET,605.1851852,60,3,6,9,0.892288862
20182019,Christopher Tanev,Defense,VAN,829.2833333,55,2,10,12,0.868219547
20182019,Clark Bishop,Center,CAR,189.1333333,20,1,2,3,0.951709552
20182019,Claude Giroux,Center,PHI,1668.433333,82,22,63,85,3.056759835
20182019,Clayton Keller,Center,ARI,1483.533333,82,14,33,47,1.900867299
20182019,Cody Ceci,Defense,OTT,1912.9,74,7,19,26,0.815515709
20182019,Cody Eakin,Center,VGK,1163.216667,78,22,19,41,2.114825269
20182019,Cody Goloubef,Defense,OTT,54.11666667,5,0,0,0,0
20182019,Cody McLeod,Left Wing,NYR/NSH,354.3666667,38,1,0,1,0.169316151
20182019,Colby Cave,Center,BOS/EDM,34.36666667,53,3,5,8,13.96702231
20182019,Colin Blackwell,Center,NSH,58.43333333,6,0,0,0,0
20182019,Colin Miller,Defense,VGK,1585.816667,65,3,26,29,1.097226455
20182019,Colin White,Center,OTT,211.85,71,14,27,41,11.61198962
20182019,Colin Wilson,Center,COL,735.1833333,65,12,15,27,2.203531999
20182019,Colton Parayko,Defense,STL,1853.116667,80,10,18,28,0.906580805
20182019,Colton Sceviour,Center,FLA,1021.416667,59,5,10,15,0.881129151
20182019,Colton Sissons,Center,NSH,1302.283333,75,15,15,30,1.382187696
20182019,Colton White,Defense,NJD,42.68333333,3,0,0,0,0
20182019,Connor Brickley,Center,NYR,523.1666667,14,1,3,4,0.458744823
20182019,Connor Brown,Right Wing,TOR,1230.2,82,8,21,29,1.414404162
20182019,Connor Carrick,Defense,DAL/NJD,711.9666667,34,2,9,11,0.927009691
20182019,Connor Clifton,Defense,BOS,330.2622222,19,0,1,1,0.181673821
20182019,Connor McDavid,Center,EDM,1765.55,78,41,75,116,3.942114355
20182019,Connor Murphy,Defense,CHI,1244.483333,52,5,8,13,0.626766128
20182019,Conor Garland,Right Wing,ARI,600.6527132,47,13,5,18,1.798043988
20182019,Conor Sheary,Left Wing,BUF,1101.616667,78,14,20,34,1.851823835
20182019,Cooper Marody,Center,EDM,41.23333333,6,0,0,0,0
20182019,Corban Knight,Center,PHI,213.854902,23,1,3,4,1.122256249
20182019,Corey Perry,Right Wing,ANA,1263.333333,31,6,4,10,0.474934037
20182019,Cory Conacher,Center,TBL,359.3333333,1,0,0,0,0
20182019,Craig Smith,Center,NSH,1214.7,76,21,17,38,1.877006668
20182019,Curtis Lazar,Center,CGY,640.3833333,1,0,0,0,0
20182019,Dakota Mermis,Defense,ARI,98.96666667,1,0,0,0,0
20182019,Dale Weise,Right Wing,PHI/MTL,486.2833333,51,5,6,11,1.357233437
20182019,Dalton Prout,Defense,CGY,55.95,20,1,1,2,2.144772118
20182019,Damon Severson,Defense,NJD,1495.916667,82,11,28,39,1.564258259
20182019,Dan Girardi,Defense,TBL,1338.583333,62,4,12,16,0.717176119
20182019,Dan Hamhuis,Defense,NSH,1612.733333,57,0,5,5,0.186019594
20182019,Danick Martel,Center,TBL,40.86666667,9,0,2,2,2.936378467
20182019,Daniel Brickley,Defense,LAK,10.8,4,0,1,1,5.555555556
20182019,Daniel Carr,Left Wing,VGK,461.1166667,6,1,0,1,0.130118914
20182019,Daniel O'Regan,Center,BUF,209.3666667,1,0,0,0,0
20182019,Daniel Sprong,Right Wing,PIT/ANA,111.8333333,63,14,9,23,12.33979136
20182019,Danny Dekeyser,Defense,DET,1317.966667,52,5,15,20,0.910493437
20182019,Danton Heinen,Center,BOS,1157.333333,77,11,23,34,1.762672811
20182019,Darnell Nurse,Defense,EDM,1823.233333,82,10,31,41,1.34925133
20182019,Darren Archibald,Left Wing,VAN/OTT,400.8833333,12,1,1,2,0.29933896
20182019,Darren Helm,Center,DET,1166.216667,61,7,10,17,0.874623069
20182019,David Backes,Center,BOS,877.5,70,7,13,20,1.367521368
20182019,David Kampf,Right Wing,CHI,589.4666667,63,4,15,19,1.933951595
20182019,David Krejci,Center,BOS,1079.516667,81,20,53,73,4.057371354
20182019,David Pastrnak,Right Wing,BOS,1473.616667,66,38,43,81,3.298008302
20182019,David Perron,Left Wing,STL,1250.283333,57,23,23,46,2.207499633
20182019,David Savard,Defense,CBJ,1569.783333,82,8,16,24,0.917324047
20182019,David Schlemko,Defense,MTL,668.4,18,0,2,2,0.179533214
20182019,Dean Kukan,Defense,CBJ,135.9833333,25,0,5,5,2.206152715
20182019,Denis Gurianov,Right Wing,DAL,228.3166667,21,1,3,4,1.051171618
20182019,Denis Malgin,Center,FLA,706.8,50,7,9,16,1.358234295
20182019,Dennis Cholowski,Defense,DET,946.0333333,52,7,9,16,1.014763398
20182019,Derek Forbort,Defense,LAK,1620.866667,81,2,12,14,0.51824127
20182019,Derek Grant,Center,PIT/ANA,732.7333333,56,4,10,14,1.146392503
20182019,Derek MacKenzie,Center,FLA,848.1833333,1,0,0,0,0
20182019,Derek Ryan,Center,CGY,1251.433333,81,13,25,38,1.821910876
20182019,Derek Stepan,Center,ARI,1580.766667,72,15,20,35,1.328469308
20182019,Derick Brassard,Center,PIT/FLA/COL,1276.183333,70,14,9,23,1.081349336
20182019,Derrick Pouliot,Defense,VAN,1267.633333,62,3,9,12,0.567987588
20182019,Deryk Engelland,Defense,VGK,1603.933333,74,2,10,12,0.448896463
20182019,Devante Smith-Pelly,Right Wing,WSH,925.8166667,54,4,4,8,0.518461178
20182019,Devin Shore,Center,DAL/ANA,1265.016667,76,10,19,29,1.375475949
20182019,Devon Toews,Defense,NYI,858.0571429,48,5,13,18,1.258657432
20182019,Dillon Dube,Center,CGY,247.5,25,1,4,5,1.212121212
20182019,Dillon Heatherington,Defense,DAL,65.1,5,0,1,1,0.921658986
20182019,Dion Phaneuf,Defense,LAK,1580.366667,67,1,5,6,0.227795237
20182019,Dmitrij Jaskin,Right Wing,WSH,945.8,37,2,6,8,0.507506872
20182019,Dmitry Kulikov,Defense,WPG,1058.2,57,0,6,6,0.34020034
20182019,Dmitry Orlov,Defense,WSH,1895.516667,82,3,26,29,0.917955527
20182019,Dominic Toninato,Center,COL,291.8,2,1,0,1,0.205620288
20182019,Dominic Turgeon,Center,DET,46.16666667,4,0,0,0,0
20182019,Dominik Kahun,Left Wing,CHI,1180.125778,82,13,24,37,1.881155417
20182019,Dominik Simon,Center,PIT,376.9333333,71,8,20,28,4.457021578
20182019,Dougie Hamilton,Defense,CAR,1766.783333,82,18,21,39,1.324440839
20182019,Drake Batherson,Center,OTT,269.2833333,20,3,6,9,2.00532277
20182019,Drake Caggiula,Center,EDM/CHI,907.8,55,12,11,23,1.520158625
20182019,Drew Doughty,Defense,LAK,2196.983333,82,8,37,45,1.228957889
20182019,Drew Stafford,Right Wing,NJD,818.0666667,57,5,8,13,0.953467525
20182019,Dryden Hunt,Center,FLA,116.1833333,31,3,7,10,5.164251901
20182019,Duncan Keith,Defense,CHI,1953.5,82,6,34,40,1.228564116
20182019,Dustin Brown,Right Wing,LAK,1601.866667,72,22,29,51,1.91027135
20182019,Dustin Byfuglien,Defense,WPG,1678.683333,42,4,27,31,1.108011239
20182019,Dylan DeMelo,Defense,OTT,891.7,77,4,18,22,1.480318493
20182019,Dylan Gambrell,Center,SJS,31.23333333,8,0,0,0,0
20182019,Dylan Larkin,Center,DET,1629,76,32,41,73,2.688766114
20182019,Dylan McIlrath,Defense,DET,104.0666667,7,0,0,0,0
20182019,Dylan Sikura,Right Wing,CHI,67,33,0,8,8,7.164179104
20182019,Dylan Strome,Center,ARI/CHI,272.6,78,20,37,57,12.54585473
20182019,Eeli Tolvanen,Left Wing,NSH,35.8,4,1,1,2,3.351955307
20182019,Elias Lindholm,Center,CGY,1446.733333,81,27,51,78,3.234873969
20182019,Elias Pettersson,Center,VAN,1303.068462,71,28,38,66,3.038980773
20182019,Eric Fehr,Right Wing,MIN,212.0666667,72,7,8,15,4.243948444
20182019,Eric Gryba,Defense,NJD,310.8833333,10,0,0,0,0
20182019,Eric Robinson,Left Wing,CBJ,11.35,13,0,0,0,0
20182019,Eric Staal,Center,MIN,1459.05,81,22,30,52,2.138377712
20182019,Eric Tangradi,Left Wing,NJD,82.68333333,6,0,1,1,0.725660149
20182019,Erik Brannstrom,Defense,OTT,36.11666667,2,0,0,0,0
20182019,Erik Burgdoerfer,Defense,OTT,26.83333333,4,0,0,0,0
20182019,Erik Cernak,Defense,TBL,1111.575472,58,5,11,16,0.863639064
20182019,Erik Condra,Right Wing,DAL,75.66666667,6,1,0,1,0.792951542
20182019,Erik Gudbranson,Defense,VAN/PIT,957.5333333,76,2,8,10,0.62661004
20182019,Erik Gustafsson,Defense,CHI,649,79,17,43,60,5.546995378
20182019,Erik Haula,Center,VGK,1321.083333,15,2,5,7,0.317920898
20182019,Erik Johnson,Defense,COL,1574.9,80,7,18,25,0.952441425
20182019,Erik Karlsson,Defense,SJS,1898.75,53,3,42,45,1.42198815
20182019,Esa Lindell,Defense,DAL,1765.366667,82,11,21,32,1.087592757
20182019,Evan Bouchard,Defense,EDM,86.48333333,7,1,0,1,0.693775294
20182019,Evan Rodrigues,Right Wing,BUF,667.4666667,74,9,20,29,2.606871754
20182019,Evander Kane,Left Wing,SJS,1526.2,75,30,26,56,2.201546324
20182019,Evgeni Malkin,Center,PIT,1481.45,68,21,51,72,2.916061966
20182019,Evgeny Dadonov,Left Wing,FLA,1382.95,82,28,42,70,3.036986153
20182019,Evgeny Kuznetsov,Center,WSH,1484.25,76,21,51,72,2.910560889
20182019,Filip Chlapik,Center,OTT,201.45,5,1,0,1,0.297840655
20182019,Filip Chytil,Center,NYR,122.2,75,11,12,23,11.29296236
20182019,Filip Forsberg,Center,NSH,1171.8,64,28,22,50,2.56016385
20182019,Filip Hronek,Defense,DET,923.3733333,46,5,18,23,1.494520093
20182019,Filip Zadina,Right Wing,DET,138.5,9,1,2,3,1.299638989
20182019,Frank Vatrano,Center,FLA,444.9,81,24,15,39,5.259608901
20182019,Frans Nielsen,Center,DET,1250.533333,72,10,25,35,1.679283506
20182019,Frederick Gaudreau,Center,NSH,183.2166667,55,3,1,4,1.309924497
20182019,Frederik Gauthier,Center,TOR,78.68333333,70,3,11,14,10.6757043
20182019,Fredrik Claesson,Defense,NYR,981.6666667,37,2,4,6,0.36672326
20182019,Gabriel Bourque,Left Wing,COL,632.25,55,2,6,8,0.759193357
20182019,Gabriel Carlsson,Defense,CBJ,158.6166667,1,0,0,0,0
20182019,Gabriel Landeskog,Left Wing,COL,1568.95,73,34,41,75,2.868160235
20182019,Garnet Hathaway,Right Wing,CGY,681.55,76,11,8,19,1.672657912
20182019,Garrett Wilson,Left Wing,PIT,378.7962963,50,2,6,8,1.267171841
20182019,Gavin Bayreuther,Defense,DAL,345.8,19,2,3,5,0.867553499
20182019,Gemel Smith,Center,DAL/BOS,433.0833333,17,2,1,3,0.415624399
20182019,Greg McKegg,Center,CAR,251.6666667,41,6,5,11,2.622516556
20182019,Greg Pateryn,Defense,MIN,1428.966667,80,1,6,7,0.293918682
20182019,Guillaume Brisebois,Defense,VAN,88.06666667,8,0,0,0,0
20182019,Gustav Forsling,Defense,CHI,785.4,43,3,6,9,0.687547746
20182019,Gustav Nyquist,Right Wing,DET/SJS,1461.866667,81,22,38,60,2.462604889
20182019,Hampus Lindholm,Defense,ANA,1569.966667,76,6,22,28,1.070086414
20182019,Haydn Fleury,Defense,CAR,1124.616667,20,0,1,1,0.053351512
20182019,Henri Jokiharju,Defense,CHI,721.7333333,38,0,12,12,0.997598374
20182019,Henrik Borgstrom,Center,FLA,50.63333333,50,8,10,18,21.32982225
20182019,Ian Cole,Defense,COL,1190.8,71,2,13,15,0.755794424
20182019,Ian McCoshen,Defense,FLA,572.8833333,19,1,1,2,0.209466733
20182019,Igor Ozhiganov,Defense,TOR,749.620915,53,3,4,7,0.560283193
20182019,Ilya Kovalchuk,Left Wing,LAK,1049.884444,64,16,18,34,1.943070983
20182019,Ilya Lyubushkin,Defense,ARI,562.5166667,41,0,4,4,0.426654025
20182019,Isac Lundestrom,Center,ANA,196.2833333,15,0,2,2,0.611361128
20182019,Ivan Barbashev,Center,STL,645.5833333,80,14,12,26,2.416419259
20182019,Ivan Provorov,Defense,PHI,1981.733333,82,7,19,26,0.787189666
20182019,J.T. Brown,Right Wing,MIN,425.75,56,3,5,8,1.127422196
20182019,J.T. Compher,Left Wing,COL,1101.983333,66,16,16,32,1.742313102
20182019,J.T. Miller,Center,TBL,1396.066667,75,13,34,47,2.019960842
20182019,Jaccob Slavin,Defense,CAR,1851.166667,82,8,23,31,1.004771766
20182019,Jack Eichel,Center,BUF,1349.683333,77,28,54,82,3.645299515
20182019,Jack Johnson,Defense,PIT,1504.9,82,1,12,13,0.518306864
20182019,Jack Rodewald,Right Wing,OTT,29.2,6,0,0,0,0
20182019,Jack Roslovic,Center,WPG,382.1333333,77,9,15,24,3.768318214
20182019,Jacob de la Rose,Center,DET,650.6166667,60,3,6,9,0.829981812
20182019,Jacob Larsson,Defense,ANA,821.6937037,49,0,5,5,0.365099548
20182019,Jacob MacDonald,Defense,FLA,24.1,2,1,0,1,2.489626556
20182019,Jacob Middleton,Defense,SJS,15.1,3,0,1,1,3.973509934
20182019,Jacob Nilsson,Center,CHI,15.71666667,2,0,0,0,0
20182019,Jacob Trouba,Defense,WPG,1204.783333,82,8,42,50,2.490074287
20182019,Jaden Schwartz,Left Wing,STL,1200.433333,69,11,25,36,1.799350235
20182019,Jake Bean,Defense,CAR,16.91666667,2,0,0,0,0
20182019,Jake DeBrusk,Left Wing,BOS,1006.133333,68,27,15,42,2.504638219
20182019,Jake Dotchin,Defense,ANA,792.1333333,20,0,1,1,0.075744824
20182019,Jake Gardiner,Defense,TOR,1844.9,62,3,27,30,0.975662638
20182019,Jake Guentzel,Left Wing,PIT,1351.866667,82,40,36,76,3.373113719
20182019,Jake McCabe,Defense,BUF,1034.35,59,4,10,14,0.81210422
20182019,Jake Muzzin,Defense,LAK/TOR,1602.133333,80,9,28,37,1.385652463
20182019,Jake Virtanen,Right Wing,VAN,899.75,70,15,10,25,1.667129758
20182019,Jakob Chychrun,Defense,ARI,1011.5,53,5,15,20,1.186356896
20182019,Jakob Forsbacka-Karlsson,Center,BOS,330.3,28,3,6,9,1.634877384
20182019,Jakob Silfverberg,Right Wing,ANA,1382.883333,73,24,19,43,1.865667145
20182019,Jakub Jerabek,Defense,STL,587.8333333,1,0,0,0,0
20182019,Jakub Voracek,Right Wing,PHI,1596.216667,78,20,46,66,2.480866215
20182019,Jakub Vrana,Left Wing,WSH,912.8666667,82,24,23,47,3.089169649
20182019,Jakub Zboril,Defense,BOS,21.95,2,0,0,0,0
20182019,James Neal,Left Wing,CGY,1220.633333,63,7,12,19,0.933941397
20182019,James Van Riemsdyk,Left Wing,PHI,1205.716667,66,27,21,48,2.388620876
20182019,Jamie Benn,Left Wing,DAL,1622.283333,78,27,26,53,1.960200129
20182019,Jamie McGinn,Left Wing,FLA,1022.45,19,4,3,7,0.410778033
20182019,Jamie Oleksiak,Defense,PIT/DAL,1131.75,57,4,8,12,0.636182903
20182019,Jan Rutta,Defense,CHI/TBL,1097.4,37,2,6,8,0.437397485
20182019,Janne Kuokkanen,Left Wing,CAR,44.55,7,0,0,0,0
20182019,Jared McCann,Center,FLA/PIT,901.4166667,78,19,16,35,2.329666266
20182019,Jared Spurgeon,Defense,MIN,1495.5,82,14,29,43,1.725175527
20182019,Jaret Anderson-Dolan,Center,LAK,58.01666667,5,0,1,1,1.034185579
20182019,Jason Demers,Defense,ARI,1457.1,35,2,6,8,0.329421454
20182019,Jason Dickinson,Left Wing,DAL,230.4833333,67,6,16,22,5.727095235
20182019,Jason Garrison,Defense,EDM,152.6166667,17,1,0,1,0.393141859
20182019,Jason Pominville,Right Wing,BUF,1221.05,73,16,15,31,1.523279145
20182019,Jason Spezza,Center,DAL,1013.983333,76,8,19,27,1.597659396
20182019,Jason Zucker,Left Wing,MIN,1390.516667,81,21,21,42,1.812276013
20182019,Jay Beagle,Right Wing,VAN,984.5333333,57,3,10,13,0.792253521
20182019,Jay Bouwmeester,Defense,STL,703.8333333,78,3,14,17,1.449206725
20182019,Jayce Hawryluk,Center,FLA,387.7810811,42,7,5,12,1.856717708
20182019,Jaycob Megna,Defense,ANA,219.8333333,28,1,3,4,1.091736164
20182019,Jean-Gabriel Pageau,Center,OTT,1306.183333,39,4,8,12,0.551224305
20182019,Jean-Sebastien Dea,Center,NJD/PIT,27.45,23,4,2,6,13.1147541
20182019,Jeff Carter,Center,LAK,479.4,76,13,20,33,4.130162703
20182019,Jeff Petry,Defense,MTL,1926.816667,82,13,33,46,1.432414431
20182019,Jeff Skinner,Left Wing,BUF,1369.516667,82,40,23,63,2.760097845
20182019,Jeremy Lauzon,Defense,BOS,248.3022222,16,1,0,1,0.241641011
20182019,Jesper Bratt,Left Wing,NJD,1128.516667,51,8,25,33,1.754515514
20182019,Jesper Fast,Left Wing,NYR,1054.15,66,8,12,20,1.138357919
20182019,Jesperi Kotkaniemi,Center,MTL,1093.562838,79,11,23,34,1.865462074
20182019,Jesse Puljujarvi,Right Wing,EDM,869.1666667,46,4,5,9,0.621284756
20182019,Jimmy Vesey,Left Wing,NYR,1133.55,81,17,18,35,1.852587005
20182019,Joakim Nordstrom,Left Wing,BOS,792.7,70,7,5,12,0.908288129
20182019,Joakim Ryan,Defense,SJS,1039.533333,44,0,7,7,0.404027448
20182019,Joe Gambardella,Center,EDM,106.2777778,15,0,3,3,1.693674856
20182019,Joe Hicketts,Defense,DET,86.73333333,11,0,0,0,0
20182019,Joe Morrow,Defense,WPG,937.6333333,41,1,6,7,0.447936294
20182019,Joe Pavelski,Right Wing,SJS,1577.866667,75,38,26,64,2.433665709
20182019,Joe Thornton,Center,SJS,862.1833333,73,16,35,51,3.549129149
20182019,Joel Armia,Right Wing,MTL,995.35,57,13,10,23,1.386446978
20182019,Joel Edmundson,Defense,STL,1431.966667,64,2,9,11,0.460904583
20182019,Joel Eriksson Ek,Center,MIN,957.4833333,58,7,7,14,0.877299866
20182019,Joel Hanley,Defense,DAL,55.65,16,0,0,0,0
20182019,Joel L'Esperance,Right Wing,DAL,223.18125,18,2,0,2,0.537679577
20182019,Joey Anderson,Right Wing,NJD,436.5678161,34,4,3,7,0.962049845
20182019,Johan Larsson,Left Wing,BUF,1129.1,73,6,8,14,0.743955363
20182019,John Carlson,Defense,WSH,2030.416667,80,13,57,70,2.06854094
20182019,John Gilmour,Defense,NYR,478.1833333,5,0,0,0,0
20182019,John Hayden,Center,CHI,509.1,54,3,2,5,0.589275192
20182019,John Klingberg,Defense,DAL,1971.283333,64,10,35,45,1.369666123
20182019,John Moore,Defense,BOS,1621.35,61,4,9,13,0.481080581
20182019,John Quenneville,Center,NJD,26.58333333,19,1,0,1,2.257053292
20182019,John Tavares,Center,TOR,1633.816667,82,47,41,88,3.231696743
20182019,Johnny Boychuk,Defense,NYI,1171.116667,74,3,16,19,0.973429917
20182019,Johnny Gaudreau,Left Wing,CGY,1554.066667,82,36,63,99,3.822229849
20182019,Jon Merrill,Defense,VGK,545.65,57,3,12,15,1.649408962
20182019,Jonas Brodin,Defense,MIN,1574,82,4,14,18,0.686149936
20182019,Jonas Siegenthaler,Defense,WSH,363.8786667,26,0,4,4,0.659560513
20182019,Jonathan Drouin,Left Wing,MTL,1354.933333,81,18,35,53,2.346978941
20182019,Jonathan Ericsson,Defense,DET,1564.6,52,3,2,5,0.191742298
20182019,Jonathan Huberdeau,Left Wing,FLA,1576.483333,82,30,62,92,3.501464229
20182019,Jonathan Marchessault,Right Wing,VGK,1348.2,82,25,34,59,2.625723186
20182019,Jonathan Toews,Center,CHI,1457.266667,82,35,46,81,3.335010751
20182019,Jonny Brodzinski,Center,LAK,332.85,13,2,1,3,0.540784137
20182019,Joonas Donskoi,Left Wing,SJS,987.5166667,80,14,23,37,2.248063324
20182019,Jordan Eberle,Right Wing,NYI,1301.483333,78,19,18,37,1.705746008
20182019,Jordan Greenway,Left Wing,MIN,67.88333333,81,12,12,24,21.21286521
20182019,Jordan Kyrou,Right Wing,STL,154.55,16,1,2,3,1.164671627
20182019,Jordan Martinook,Left Wing,CAR,1137.866667,82,15,10,25,1.318256386
20182019,Jordan Nolan,Center,STL,676.85,14,0,2,2,0.177291867
20182019,Jordan Oesterle,Defense,ARI,1129.2,71,6,14,20,1.062699256
20182019,Jordan Schmaltz,Defense,STL,142.6666667,20,0,2,2,0.841121495
20182019,Jordan Staal,Center,CAR,1522.366667,50,11,17,28,1.103544919
20182019,Jordan Weal,Center,PHI/ARI/MTL,893.3,63,8,13,21,1.410500392
20182019,Jordie Benn,Defense,MTL,1460.266667,81,5,17,22,0.903944485
20182019,Jori Lehtera,Center,PHI,652.2333333,27,1,2,3,0.275974856
20182019,Joseph Blandisi,Center,ANA/PIT,35.03333333,9,0,0,0,0
20182019,Josh Anderson,Right Wing,CBJ,1137.45,82,27,20,47,2.479229856
20182019,Josh Archibald,Right Wing,ARI,502.3166667,68,12,10,22,2.627824414
20182019,Josh Bailey,Left Wing,NYI,1359.216667,82,16,40,56,2.472012066
20182019,Josh Brown,Defense,FLA,470.6758065,37,1,1,2,0.254952556
20182019,Josh Currie,Center,EDM,186.8125,21,2,3,5,1.605888257
20182019,Josh Jacobs,Defense,NJD,14.9,1,0,0,0,0
20182019,Josh Leivo,Left Wing,TOR/VAN,169.0833333,76,14,10,24,8.516510596
20182019,Josh Mahura,Defense,ANA,242.95,17,1,4,5,1.23482198
20182019,Josh Manson,Defense,ANA,1627.533333,74,3,13,16,0.58984967
20182019,Josh Morrissey,Defense,WPG,1656.583333,59,6,25,31,1.122792897
20182019,Joshua Ho-Sang,Right Wing,NYI,314.15,10,1,1,2,0.381983129
20182019,Juho Lammikko,Center,FLA,435.8833333,40,0,6,6,0.825909074
20182019,Jujhar Khaira,Left Wing,EDM,877.4166667,60,3,15,18,1.230886124
20182019,Julius Honka,Defense,DAL,544.6,29,0,4,4,0.440690415
20182019,Justin Abdelkader,Left Wing,DET,1241.783333,71,6,13,19,0.918034547
20182019,Justin Bailey,Right Wing,PHI,135.3333333,11,0,1,1,0.443349754
20182019,Justin Braun,Defense,SJS,1727.833333,78,2,14,16,0.555609144
20182019,Justin Dowling,Center,DAL,142.7020833,11,0,1,1,0.42045637
20182019,Justin Falk,Defense,OTT,737.7666667,10,0,0,0,0
20182019,Justin Faulk,Defense,CAR,1689.833333,82,11,24,35,1.242726107
20182019,Justin Holl,Defense,TOR,34.71666667,11,0,1,1,1.728276524
20182019,Justin Kloos,Right Wing,ANA,8.65,1,0,0,0,0
20182019,Justin Schultz,Defense,PIT,1229.2,29,2,13,15,0.732183534
20182019,Justin Williams,Right Wing,CAR,1359.866667,82,23,30,53,2.338464555
20182019,Juuso Riikola,Defense,PIT,617.65,37,2,3,5,0.485711973
20182019,Juuso Valimaki,Defense,CGY,362.1636364,24,1,2,3,0.497012902
20182019,Kailer Yamamoto,Center,EDM,136.4333333,17,1,1,2,0.879550452
20182019,Kalle Kossila,Left Wing,ANA,90.85,8,1,0,1,0.660429279
20182019,Karl Alzner,Defense,MTL,1645.766667,9,0,1,1,0.036457173
20182019,Karson Kuhlman,Right Wing,BOS,131.45,11,3,2,5,2.282236592
20182019,Kasperi Kapanen,Right Wing,TOR,426.95,78,20,24,44,6.18339384
20182019,Keith Yandle,Defense,FLA,2009.083333,82,9,53,62,1.851590692
20182019,Kenny Agostino,Left Wing,MTL/NJD,60.21666667,63,6,18,24,23.91364517
20182019,Kerby Rychel,Left Wing,CGY,44.11666667,2,0,0,0,0
20182019,Kevan Miller,Defense,BOS,1323.383333,39,0,7,7,0.317368361
20182019,Kevin Connauton,Defense,ARI,1107.933333,50,1,7,8,0.433239064
20182019,Kevin Fiala,Center,NSH/MIN,1212.2,83,13,26,39,1.930374526
20182019,Kevin Gravel,Defense,EDM,224.2166667,36,0,3,3,0.802794916
20182019,Kevin Hayes,Right Wing,NYR/WPG,1317.933333,71,19,36,55,2.503920279
20182019,Kevin Labanc,Right Wing,SJS,1103.716667,82,17,39,56,3.044259547
20182019,Kevin Rooney,Center,NJD,11.76666667,41,6,4,10,50.99150142
20182019,Kevin Roy,Left Wing,ANA,341.2166667,3,0,0,0,0
20182019,Kevin Shattenkirk,Defense,NYR,931.2,73,2,26,28,1.804123711
20182019,Kevin Stenlund,Center,CBJ,43.85,4,0,0,0,0
20182019,Kiefer Sherwood,Right Wing,ANA,562.9609929,50,6,6,12,1.278951844
20182019,Kole Sherwood,Right Wing,CBJ,18.45,2,0,0,0,0
20182019,Korbinian Holzer,Defense,ANA,185.85,22,1,3,4,1.291364003
20182019,Kris Letang,Defense,PIT,2000.583333,65,16,40,56,1.679510143
20182019,Kris Russell,Defense,EDM,1488.05,72,3,13,16,0.645139612
20182019,Kristian Vesalainen,Left Wing,WPG,34.2,5,0,1,1,1.754385965
20182019,Kurtis Gabriel,Right Wing,NJD,162.6333333,22,2,2,4,1.475712236
20182019,Kurtis MacDermid,Defense,LAK,394.2666667,11,0,1,1,0.152181265
20182019,Kyle Brodziak,Center,EDM,1088.866667,70,6,3,9,0.495928488
20182019,Kyle Capobianco,Defense,ARI,13.55,2,0,0,0,0
20182019,Kyle Clifford,Left Wing,LAK,527.5166667,72,11,10,21,2.388550125
20182019,Kyle Connor,Center,WPG,1284.916667,82,34,32,66,3.081911927
20182019,Kyle Okposo,Right Wing,BUF,1294.083333,78,14,15,29,1.344581106
20182019,Kyle Palmieri,Right Wing,NJD,1072.716667,74,27,23,50,2.79663782
20182019,Kyle Rau,Left Wing,MIN,33.08333333,6,0,1,1,1.813602015
20182019,Kyle Turris,Center,NSH,1261.183333,55,7,16,23,1.094210464
20182019,Lars Eller,Center,WSH,1236.716667,81,13,23,36,1.746560112
20182019,Laurent Dauphin,Center,ARI,14.45,1,0,0,0,0
20182019,Lawrence Pilut,Defense,BUF,572.9942308,33,1,5,6,0.628278577
20182019,Lawson Crouse,Left Wing,ARI,120.0666667,81,11,14,25,12.49305941
20182019,Lee Stempniak,Right Wing,BOS,461.4666667,2,0,0,0,0
20182019,Leo Komarov,Center,NYI,1166.716667,82,6,20,26,1.337085553
20182019,Leon Draisaitl,Center,EDM,1502.233333,82,50,55,105,4.193755963
20182019,Lias Andersson,Center,NYR,83.61666667,42,2,4,6,4.30536177
20182019,Libor Hajek,Defense,NYR,82.65,5,1,0,1,0.725952813
20182019,Libor Sulak,Defense,DET,116.2833333,6,0,0,0,0
20182019,Logan Brown,Center,OTT,32.51666667,2,0,0,0,0
20182019,Logan Couture,Center,SJS,1446.25,81,27,43,70,2.90406223
20182019,Logan O'Connor,Right Wing,COL,34.06666667,5,0,0,0,0
20182019,Loui Eriksson,Right Wing,VAN,813.3,81,11,18,29,2.139431944
20182019,Louie Belpedio,Defense,MIN,13.98333333,2,0,0,0,0
20182019,Luca Sbisa,Defense,NYI,585.55,9,0,1,1,0.102467765
20182019,Lucas Wallmark,Center,CAR,104.4333333,81,10,18,28,16.08681775
20182019,Lukas Radil,Left Wing,SJS,386.64,36,7,4,11,1.707014277
20182019,Lukas Sedlak,Center,CBJ,497.7666667,47,4,2,6,0.723230429
20182019,Luke Glendening,Center,DET,910.0333333,78,10,13,23,1.51642797
20182019,Luke Johnson,Center,CHI,162.1833333,15,0,1,1,0.369951701
20182019,Luke Kunin,Center,MIN,246.5666667,49,6,11,17,4.136812221
20182019,Luke Schenn,Defense,ANA/VAN,1048.333333,26,0,2,2,0.114467409
20182019,Luke Witkowski,Defense,DET,213.4833333,34,0,2,2,0.56210477
20182019,Mackenzie MacEachern,Left Wing,STL,231.6833333,29,3,2,5,1.294870873
20182019,MacKenzie Weegar,Defense,FLA,874.3666667,64,4,11,15,1.029316458
20182019,Madison Bowey,Defense,WSH/DET,698.3,50,2,8,10,0.859229557
20182019,Magnus Paajarvi,Left Wing,OTT,983.5666667,80,11,8,19,1.159047006
20182019,Marc Methot,Defense,DAL,641.9,9,0,0,0,0
20182019,Marc Staal,Defense,NYR,1336.466667,79,3,10,13,0.583628473
20182019,Marc-Edouard Vlasic,Defense,SJS,1826.166667,72,3,22,25,0.821392717
20182019,Marco Scandella,Defense,BUF,1911.983333,63,6,7,13,0.407953347
20182019,Marcus Foligno,Left Wing,MIN,836.8666667,82,7,12,19,1.36222417
20182019,Marcus Johansson,Left Wing,NJD/BOS,463.0666667,58,13,17,30,3.887129283
20182019,Marcus Kruger,Center,CHI,519.9666667,74,4,8,12,1.384704148
20182019,Marcus Pettersson,Defense,ANA/PIT,300.0833333,84,2,23,25,4.998611497
20182019,Marcus Sorensen,Left Wing,SJS,324.3833333,80,17,13,30,5.548990392
20182019,Mario Kempe,Left Wing,ARI,199.6,52,4,5,9,2.705410822
20182019,Mark Alt,Defense,COL,186.0166667,2,0,0,0,0
20182019,Mark Barberio,Defense,COL,794.1833333,12,1,0,1,0.075549306
20182019,Mark Borowiecki,Defense,OTT,761.2666667,53,1,4,5,0.394080042
20182019,Mark Giordano,Defense,CGY,2031.4,78,17,57,74,2.185684749
20182019,Mark Jankowski,Center,CGY,963.0333333,79,14,18,32,1.99370046
20182019,Mark Letestu,Center,CBJ,1027.166667,2,0,0,0,0
20182019,Mark Pysyk,Defense,FLA,1537.966667,70,1,10,11,0.429138039
20182019,Mark Scheifele,Center,WPG,1240.333333,82,38,46,84,4.063423811
20182019,Mark Stone,Right Wing,OTT/VGK,1199,77,33,40,73,3.653044204
20182019,Marko Dano,Left Wing,COL,165.3,8,0,0,0,0
20182019,Markus Granlund,Center,VAN,861.6833333,77,12,10,22,1.531885263
20182019,Markus Hannikainen,Left Wing,CBJ,275.0666667,44,4,3,7,1.526902569
20182019,Markus Nutivaara,Defense,CBJ,977.7333333,80,5,16,21,1.288694941
20182019,Martin Frk,Right Wing,DET,700.0166667,30,1,5,6,0.51427347
20182019,Martin Hanzal,Center,DAL,535.9,7,1,1,2,0.223922374
20182019,Martin Marincin,Defense,TOR,33.35,24,1,4,5,8.995502249
20182019,Martin Necas,Center,CAR,6.383333333,7,1,1,2,18.79895561
20182019,Mason Appleton,Center,WPG,295.3666667,36,3,7,10,2.031373434
20182019,Mathew Barzal,Center,NYI,1456.733333,82,18,44,62,2.553658871
20182019,Mathieu Joseph,Right Wing,TBL,788.7020202,70,13,13,26,1.977933313
20182019,Mathieu Perreault,Center,WPG,1013.166667,82,15,15,30,1.776607995
20182019,Mats Zuccarello,Left Wing,NYR/DAL,1513.933333,48,12,28,40,1.585274561
20182019,Matt Bartkowski,Defense,MIN,240.1833333,2,1,0,1,0.249809174
20182019,Matt Beleskey,Left Wing,NYR,164.4833333,4,1,0,1,0.3647786
20182019,Matt Calvert,Left Wing,COL,923.4,82,11,15,26,1.689408707
20182019,Matt Cullen,Center,PIT,939.6833333,71,7,13,20,1.277025948
20182019,Matt Donovan,Defense,NSH,14.78333333,2,0,1,1,4.058624577
20182019,Matt Duchene,Center,OTT/CBJ,1502.766667,73,31,39,70,2.794845064
20182019,Matt Dumba,Defense,MIN,1952.533333,32,12,10,22,0.676044797
20182019,Matt Grzelcyk,Defense,BOS,1021.2,66,3,15,18,1.057579318
20182019,Matt Hendricks,Left Wing,MIN/WPG,565.2333333,26,0,3,3,0.318452556
20182019,Matt Hunwick,Defense,BUF,736.1833333,14,0,2,2,0.163002875
20182019,Matt Irwin,Defense,NSH,671.4166667,44,1,6,7,0.625543006
20182019,Matt Luff,Right Wing,LAK,366.3166667,33,8,3,11,1.801719823
20182019,Matt Martin,Left Wing,NYI,399.4166667,67,6,8,14,2.103066973
20182019,Matt Nieto,Left Wing,COL,1101.816667,64,4,19,23,1.25247697
20182019,Matt Niskanen,Defense,WSH,1537.05,80,8,17,25,0.975895384
20182019,Matt Puempel,Left Wing,DET,70.6,8,1,0,1,0.849858357
20182019,Matt Read,Right Wing,MIN,207.1333333,12,1,0,1,0.289668491
20182019,Matt Roy,Defense,LAK,423.2638889,25,2,4,6,0.850533224
20182019,Matt Tennyson,Defense,BUF,268.85,4,0,0,0,0
20182019,Matthew Benning,Defense,EDM,1260.766667,70,5,12,17,0.809031542
20182019,Matthew Peca,Center,MTL,136.6833333,39,3,7,10,4.389708572
20182019,Matthew Tkachuk,Left Wing,CGY,1173.083333,80,34,43,77,3.938339135
20182019,Mattias Ekholm,Defense,NSH,1909.9,80,8,36,44,1.382271323
20182019,Mattias Janmark,Center,DAL,1370.366667,81,6,19,25,1.094597553
20182019,Max Domi,Left Wing,MTL,1369.616667,82,28,44,72,3.154167224
20182019,Max Jones,Left Wing,ANA,389.44,30,2,3,5,0.770336894
20182019,Max Lajoie,Defense,OTT,1058.833333,56,7,8,15,0.84999213
20182019,Max McCormick,Left Wing,OTT,250.5333333,14,1,0,1,0.23948909
20182019,Max Pacioretty,Left Wing,VGK,1216.783333,66,22,18,40,1.972413604
20182019,Max Veronneau,Center,OTT,183.44,12,2,2,4,1.308329699
20182019,Maxim Mamin,Left Wing,FLA,274.2,7,0,0,0,0
20182019,Maxime Comtois,Left Wing,ANA,145.9,10,2,5,7,2.87868403
20182019,Melker Karlsson,Center,SJS,940.4166667,79,12,4,16,1.020824103
20182019,Michael Amadio,Center,LAK,344,43,6,7,13,2.26744186
20182019,Michael Bunting,Left Wing,ARI,47.66666667,5,1,0,1,1.258741259
20182019,Michael Chaput,Center,MTL,87.75,32,0,5,5,3.418803419
20182019,Michael Dal Colle,Left Wing,NYI,53.41666667,28,3,4,7,7.862714509
20182019,Michael Del Zotto,Defense,VAN/ANA/STL,1707.116667,42,1,9,10,0.351469827
20182019,Michael Frolik,Right Wing,CGY,1184.166667,65,16,18,34,1.722730471
20182019,Michael Grabner,Right Wing,ARI,1184.65,41,9,7,16,0.810365931
20182019,Michael Matheson,Defense,FLA,1727.516667,75,8,19,27,0.937762298
20182019,Michael McLeod,Center,NJD,256.85625,21,0,3,3,0.700781079
20182019,Michael Raffl,Left Wing,PHI,1007.333333,67,6,12,18,1.072137657
20182019,Michael Rasmussen,Center,DET,747.8,62,8,10,18,1.444236427
20182019,Michael Stone,Defense,CGY,1372.183333,14,0,5,5,0.218629678
20182019,Michal Kempny,Defense,WSH,843.65,71,6,19,25,1.777988502
20182019,Micheal Ferland,Left Wing,CAR,1156.516667,71,17,23,40,2.075197072
20182019,Micheal Haley,Center,FLA/SJS,584.45,43,2,4,6,0.615963727
20182019,Miikka Salomaki,Right Wing,NSH,595.0833333,37,3,4,7,0.705783504
20182019,Mika Zibanejad,Center,NYR,1293.916667,82,30,44,74,3.431442004
20182019,Mikael Backlund,Center,CGY,1559.066667,77,21,26,47,1.80877448
20182019,Mikael Granlund,Center,MIN/NSH,1444.466667,79,16,38,54,2.243042415
20182019,Mike Green,Defense,DET,1456.7,43,5,21,26,1.070913709
20182019,Mike Hoffman,Left Wing,FLA,1508.266667,82,36,34,70,2.784653465
20182019,Mike Reilly,Defense,MTL,853.8166667,57,3,8,11,0.772999668
20182019,Mikhail Sergachev,Defense,TBL,1212.55,75,6,26,32,1.583439858
20182019,Mikhail Vorobyov,Center,PHI,140,15,1,1,2,0.857142857
20182019,Mikkel Boedker,Left Wing,OTT,988.9166667,71,7,28,35,2.123535856
20182019,Mikko Koivu,Center,MIN,1512.6,48,8,21,29,1.150337168
20182019,Mikko Rantanen,Right Wing,COL,1533.383333,74,31,56,87,3.404236818
20182019,Milan Lucic,Left Wing,EDM,1307.65,79,6,14,20,0.917676748
20182019,Miles Wood,Left Wing,NJD,946.5666667,63,10,14,24,1.52128746
20182019,Mirco Mueller,Defense,NJD,466.9166667,53,1,10,11,1.413528467
20182019,Miro Heiskanen,Defense,DAL,1894.487719,82,12,21,33,1.045137416
20182019,Mitch Marner,Center,TOR,1343.7,82,26,68,94,4.197365483
20182019,Morgan Rielly,Defense,TOR,1640.383333,82,20,52,72,2.63353078
20182019,Nate Prosser,Defense,MIN,767.0333333,15,0,0,0,0
20182019,Nate Schmidt,Defense,VGK,1694.416667,61,9,21,30,1.062312497
20182019,Nate Thompson,Center,LAK/MTL,881.6,78,5,8,13,0.884754991
20182019,Nathan Bastian,Center,NJD,87.9375,7,3,0,3,2.046908316
20182019,Nathan Beaulieu,Defense,BUF/WPG,939.7,48,3,9,12,0.766201979
20182019,Nathan MacKinnon,Center,COL,1472.516667,82,41,58,99,4.033910199
20182019,Nathan Walker,Left Wing,WSH,85.28333333,3,0,1,1,0.703537229
20182019,Nazem Kadri,Center,TOR,1341.45,73,16,28,44,1.96801968
20182019,Neal Pionk,Defense,NYR,628.2833333,73,6,20,26,2.482956203
20182019,Nelson Nogier,Defense,WPG,10.1,1,0,0,0,0
20182019,Nic Dowd,Center,WSH,588.25,64,8,14,22,2.243943901
20182019,Nic Petan,Center,WPG/TOR,126.2,18,1,2,3,1.426307448
20182019,Nick Bjugstad,Center,FLA/PIT,1239.3,64,14,12,26,1.258775115
20182019,Nick Bonino,Center,NSH,1110.133333,81,17,18,35,1.891664665
20182019,Nick Cousins,Center,ARI,912.7666667,81,7,20,27,1.774823796
20182019,Nick Foligno,Left Wing,CBJ,1320.983333,73,17,18,35,1.589724826
20182019,Nick Holden,Defense,VGK,1387.45,61,3,12,15,0.648672024
20182019,Nick Jensen,Defense,DET/WSH,1316.516667,80,2,18,20,0.911496246
20182019,Nick Lappin,Center,NJD,58.56666667,11,0,0,0,0
20182019,Nick Leddy,Defense,NYI,1793.55,82,4,22,26,0.86978339
20182019,Nick Paul,Center,OTT,86.86666667,20,1,1,2,1.381427475
20182019,Nick Ritchie,Left Wing,ANA,1002.366667,60,9,22,31,1.855608393
20182019,Nick Schmaltz,Center,CHI/ARI,1420.166667,40,7,18,25,1.056214059
20182019,Nick Seeler,Defense,MIN,318.45,71,2,5,7,1.318888366
20182019,Nicklas Backstrom,Center,WSH,1590.083333,80,22,52,74,2.792306483
20182019,Nico Hischier,Center,NJD,1336.3,69,17,30,47,2.110304572
20182019,Nicolas Aube-Kubel,Right Wing,PHI,50.3,9,0,0,0,0
20182019,Nicolas Deslauriers,Left Wing,MTL,672.0833333,48,2,3,5,0.446373218
20182019,Nicolas Roy,Center,CAR,10.76666667,6,0,0,0,0
20182019,Nikita Kucherov,Right Wing,TBL,1585.15,82,41,87,128,4.844967353
20182019,Nikita Scherbak,Left Wing,LAK,347.8166667,8,1,0,1,0.172504672
20182019,Nikita Soshnikov,Left Wing,STL,165.2666667,5,0,0,0,0
20182019,Nikita Zadorov,Defense,COL,1493.416667,70,7,7,14,0.562468612
20182019,Nikita Zaitsev,Defense,TOR,1333.083333,81,3,11,14,0.630118147
20182019,Niklas Hjalmarsson,Defense,ARI,996.2166667,82,0,10,10,0.602278621
20182019,Niklas Kronwall,Defense,DET,1463.633333,79,3,24,27,1.10683459
20182019,Nikolaj Ehlers,Left Wing,WPG,1318.55,62,21,16,37,1.683667665
20182019,Nikolay Goldobin,Right Wing,VAN,468.1333333,63,7,20,27,3.460552549
20182019,Nino Niederreiter,Right Wing,MIN/CAR,944.1666667,82,23,30,53,3.368049426
20182019,Noah Hanifin,Defense,CGY,1487.683333,80,5,28,33,1.330928401
20182019,Noah Juulsen,Defense,MTL,446.7,21,1,4,5,0.671591672
20182019,Noel Acciari,Center,BOS,774.8333333,72,6,8,14,1.084104108
20182019,Nolan Patrick,Center,PHI,1001.6,72,13,18,31,1.857028754
20182019,Oliver Bjorkstrand,Right Wing,CBJ,1172.566667,77,23,13,36,1.842112744
20182019,Oliver Ekman-Larsson,Defense,ARI,1940.816667,81,14,30,44,1.360252128
20182019,Oliver Kylington,Defense,CGY,463.6175926,38,3,5,8,1.035336035
20182019,Olli Maatta,Defense,PIT,1537.866667,60,1,13,14,0.546211202
20182019,Ondrej Kase,Right Wing,ANA,918.8333333,30,11,9,20,1.306003991
20182019,Ondrej Palat,Left Wing,TBL,952.8666667,64,8,26,34,2.140908137
20182019,Oscar Fantenberg,Defense,LAK/CGY,383.1,61,2,2,4,0.626468285
20182019,Oscar Klefbom,Defense,EDM,1506.383333,61,5,23,28,1.115253975
20182019,Oscar Lindberg,Center,VGK/OTT,739.9,55,9,11,20,1.621840789
20182019,Oskar Lindblom,Left Wing,PHI,335.4666667,81,17,16,33,5.902225755
20182019,Oskar Sundqvist,Center,STL,439.4166667,74,14,17,31,4.232884506
20182019,P.K. Subban,Defense,NSH,1976.916667,63,9,22,31,0.940859082
20182019,Par Lindholm,Center,TOR/WPG,741.0343915,65,1,12,13,1.052582726
20182019,Patric Hornqvist,Right Wing,PIT,1212.816667,69,18,19,37,1.830449779
20182019,Patrice Bergeron,Center,BOS,1244.4,65,32,47,79,3.809064609
20182019,Patrick Eaves,Right Wing,ANA,32.91666667,7,0,0,0,0
20182019,Patrick Kane,Right Wing,CHI,1653.183333,81,44,66,110,3.992297688
20182019,Patrick Marleau,Left Wing,TOR,1392.25,82,16,21,37,1.59454121
20182019,Patrick Maroon,Left Wing,STL,1223.716667,74,10,18,28,1.372866813
20182019,Patrick Russell,Right Wing,EDM,52.71666667,6,0,0,0,0
20182019,Patrik Berglund,Center,BUF,918.55,23,2,2,4,0.261281367
20182019,Patrik Laine,Right Wing,WPG,1353.666667,82,30,20,50,2.216202906
20182019,Patrik Nemeth,Defense,COL,1349.4,74,1,9,10,0.444642063
20182019,Paul Byron,Left Wing,MTL,1322.25,56,15,16,31,1.406693137
20182019,Paul Carey,Left Wing,OTT/BOS,617.4333333,7,0,0,0,0
20182019,Paul LaDue,Defense,LAK,167.8333333,33,2,3,5,1.787487587
20182019,Paul Stastny,Center,VGK,1500.766667,50,13,29,42,1.679141772
20182019,Pavel Buchnevich,Left Wing,NYR,1110.166667,64,21,17,38,2.053745684
20182019,Pavel Zacha,Left Wing,NJD,991.5166667,61,13,12,25,1.512833874
20182019,Peter Cehlarik,Left Wing,BOS,83.6,20,4,2,6,4.306220096
20182019,Phil Kessel,Right Wing,PIT,1532.233333,82,27,55,82,3.210999195
20182019,Phil Varone,Center,PHI,364.924031,47,3,4,7,1.150924478
20182019,Philippe Myers,Defense,PHI,323.4875,21,1,1,2,0.370957147
20182019,Phillip Danault,Center,MTL,862.1833333,81,12,41,53,3.688310684
20182019,Phillip Di Giuseppe,Left Wing,CAR/NSH,514.6,24,1,3,4,0.466381656
20182019,Pierre-Edouard Bellemare,Left Wing,VGK,884.7833333,76,6,9,15,1.017198184
20182019,Pierre-Luc Dubois,Left Wing,CBJ,1362.916667,82,27,34,61,2.685417304
20182019,Pontus Aberg,Right Wing,ANA/MIN,644.9333333,59,12,13,25,2.32582179
20182019,Radek Faksa,Center,DAL,1203.733333,81,15,15,30,1.495347807
20182019,Radim Simek,Defense,SJS,625.0833333,41,1,8,9,0.863884815
20182019,Radko Gudas,Defense,PHI,1196.083333,77,4,16,20,1.003274577
20182019,Rasmus Andersson,Defense,CGY,154.9,79,2,17,19,7.35958683
20182019,Rasmus Dahlin,Defense,BUF,1735.958222,82,9,35,44,1.520773925
20182019,Rasmus Ristolainen,Defense,BUF,1934.666667,78,5,38,43,1.33356306
20182019,Reid Boucher,Left Wing,VAN,227.5166667,1,0,0,0,0
20182019,Reilly Smith,Right Wing,VGK,1204.966667,74,19,34,53,2.639077153
20182019,Rem Pitlick,Center,NSH,9.716666667,1,0,0,0,0
20182019,Remi Elie,Left Wing,BUF,738.1166667,16,0,1,1,0.081287963
20182019,Richard Panik,Right Wing,ARI,1094.583333,75,14,19,33,1.808907499
20182019,Rickard Rakell,Right Wing,ANA,1496.35,69,18,25,43,1.724195542
20182019,Riley Nash,Center,CBJ,1172.183333,78,3,9,12,0.614238387
20182019,Riley Sheahan,Center,PIT/FLA,1188.116667,82,9,10,19,0.959501732
20182019,Riley Stillman,Defense,FLA,11.36666667,1,0,0,0,0
20182019,Robby Fabbri,Center,STL,406.2933333,32,2,4,6,0.886059333
20182019,Robert Bortuzzo,Defense,STL,1063.216667,59,2,8,10,0.564325239
20182019,Robert Hagg,Defense,PHI,1269.916667,82,5,15,20,0.944943894
20182019,Robert Thomas,Center,STL,902.4713542,70,9,24,33,2.193975455
20182019,Rocco Grimaldi,Right Wing,NSH,57.85,53,5,8,13,13.48314607
20182019,Roman Josi,Defense,NSH,1832.05,82,15,41,56,1.83401108
20182019,Roman Polak,Defense,DAL,950.2833333,77,1,8,9,0.568251574
20182019,Ron Hainsey,Defense,TOR,1745.8,81,5,18,23,0.790468553
20182019,Roope Hintz,Left Wing,DAL,798.5038462,58,9,13,22,1.653091599
20182019,Ross Johnston,Left Wing,NYI,224.0333333,17,1,3,4,1.071269156
20182019,Rourke Chartier,Center,SJS,122.2333333,13,1,0,1,0.490864467
20182019,Rudolfs Balcers,Left Wing,OTT,445.68,36,5,9,14,1.884760366
20182019,Ryan Callahan,Right Wing,TBL,892.5333333,52,7,10,17,1.142814461
20182019,Ryan Carpenter,Center,VGK,655.35,68,5,13,18,1.647974365
20182019,Ryan Donato,Center,BOS/MIN,176.35,56,10,15,25,8.505812305
20182019,Ryan Dzingel,Center,OTT/CBJ,1303.4,78,26,30,56,2.577873255
20182019,Ryan Ellis,Defense,NSH,1027.116667,82,7,34,41,2.395054116
20182019,Ryan Getzlaf,Center,ANA,1200.816667,67,14,34,48,2.398367777
20182019,Ryan Graves,Defense,COL,289.1833333,26,3,2,5,1.037404184
20182019,Ryan Hartman,Right Wing,NSH/PHI,1018.7,83,12,14,26,1.531363503
20182019,Ryan Johansen,Center,NSH,1463.383333,80,14,50,64,2.624056126
20182019,Ryan Kesler,Center,ANA,791.7833333,60,5,3,8,0.606226451
20182019,Ryan Kuffner,Center,DET,86.29166667,10,0,0,0,0
20182019,Ryan Lindgren,Defense,NYR,68.61111111,5,0,0,0,0
20182019,Ryan Lomberg,Left Wing,CGY,43.75,4,0,0,0,0
20182019,Ryan McDonagh,Defense,TBL,1469.95,82,9,37,46,1.877614885
20182019,Ryan Murphy,Defense,MIN/NJD,397.9166667,3,0,1,1,0.15078534
20182019,Ryan Murray,Defense,CBJ,809.9333333,56,1,28,29,2.148324965
20182019,Ryan Nugent-Hopkins,Center,EDM,1121.516667,82,28,41,69,3.69142976
20182019,Ryan O'Reilly,Center,STL,1685.466667,82,28,49,77,2.741080611
20182019,Ryan Pulock,Defense,NYI,1251.216667,82,9,28,37,1.774273041
20182019,Ryan Reaves,Right Wing,VGK,600.2333333,80,9,11,20,1.999222525
20182019,Ryan Spooner,Center,NYR/EDM/VAN,899.5666667,52,3,6,9,0.600289028
20182019,Ryan Strome,Center,EDM/NYR,1248.483333,81,19,16,35,1.682040876
20182019,Ryan Suter,Defense,MIN,2083.95,82,7,40,47,1.353199453
20182019,Saku Maenalanen,Left Wing,CAR,320.3791667,34,4,4,8,1.49822476
20182019,Sam Bennett,Center,CGY,1181.633333,71,13,14,27,1.370983667
20182019,Sam Carrick,Center,ANA,59.1,6,0,1,1,1.015228426
20182019,Sam Gagner,Center,VAN/EDM,1118.5,32,6,7,13,0.697362539
20182019,Sam Reinhart,Right Wing,BUF,1402.233333,82,22,43,65,2.781277486
20182019,Sam Steel,Center,ANA,319.3019608,22,6,5,11,2.067008917
20182019,Sami Niku,Defense,WPG,15.21666667,30,1,3,4,15.77217963
20182019,Sami Vatanen,Defense,NJD,1613.283333,50,4,13,17,0.632251
20182019,Samuel Blais,Left Wing,STL,117.65,32,2,2,4,2.039949001
20182019,Samuel Girard,Defense,COL,1286.9,82,4,23,27,1.258839071
20182019,Samuel Morin,Defense,PHI,31.61666667,5,0,0,0,0
20182019,Scott Harrington,Defense,CBJ,425.5833333,73,2,15,17,2.396710397
20182019,Scott Laughton,Center,PHI,900.4333333,82,12,20,32,2.132306667
20182019,Scott Mayfield,Defense,NYI,836.6333333,79,4,15,19,1.362604088
20182019,Scott Wilson,Left Wing,BUF,841.3,15,0,3,3,0.213954594
20182019,Sean Couturier,Center,PHI,1769.333333,80,33,43,76,2.577241899
20182019,Sean Kuraly,Center,BOS,918.5166667,71,8,13,21,1.371776959
20182019,Sean Monahan,Center,CGY,1381.716667,78,34,48,82,3.560787909
20182019,Sean Walker,Defense,LAK,593.2828571,39,3,7,10,1.01132199
20182019,Sebastian Aho,Center,CAR,1627.266667,82,30,53,83,3.060346593
20182019,Seth Jones,Defense,CBJ,1919.133333,75,9,37,46,1.438149165
20182019,Shayne Gostisbehere,Defense,PHI,1671.916667,78,9,28,37,1.327817375
20182019,Shea Theodore,Defense,VGK,1239.366667,79,12,25,37,1.79123746
20182019,Shea Weber,Defense,MTL,659.05,58,14,19,33,3.004324406
20182019,Sheldon Dries,Center,COL,362.8833333,40,3,3,6,0.992054379
20182019,Sheldon Rempal,Right Wing,LAK,64.23333333,7,0,0,0,0
20182019,Sidney Crosby,Center,PIT,1696.5,79,35,65,100,3.536693192
20182019,Slater Koekkoek,Defense,TBL/CHI,391.6833333,31,2,4,6,0.919109825
20182019,Sonny Milano,Left Wing,CBJ,640.7333333,8,1,0,1,0.093642701
20182019,Stefan Elliott,Defense,OTT,26.95,3,0,1,1,2.226345083
20182019,Stefan Noesen,Right Wing,NJD,958.1833333,41,3,5,8,0.500947974
20182019,Stephen Gionta,Center,NYI,43.91666667,5,0,0,0,0
20182019,Steven Fogarty,Center,NYR,12.26666667,10,0,0,0,0
20182019,Steven Kampfer,Defense,BOS,379.5333333,35,3,3,6,0.948533286
20182019,Steven Santini,Defense,NJD,729.85,39,1,3,4,0.328834692
20182019,Steven Stamkos,Center,TBL,1464.4,82,45,53,98,4.015296367
20182019,Sven Andrighetto,Right Wing,COL,722.6666667,64,7,10,17,1.411439114
20182019,Sven Baertschi,Left Wing,VAN,825.8666667,26,9,5,14,1.017113335
20182019,T.J. Oshie,Right Wing,WSH,1361.1,69,25,29,54,2.380427595
20182019,Tage Thompson,Center,BUF,488.85,65,7,5,12,1.472844431
20182019,Tanner Fritz,Center,NYI,425.7333333,8,0,1,1,0.140933292
20182019,Tanner Pearson,Left Wing,LAK/PIT/VAN,1308.25,80,18,9,27,1.238295433
20182019,Taro Hirose,Center,DET,150.7916667,10,1,6,7,2.785299807
20182019,Taylor Fedun,Defense,DAL,102.7833333,54,4,7,11,6.421274526
20182019,Taylor Hall,Left Wing,NJD,1453.733333,33,11,26,37,1.527102632
20182019,Teddy Blueger,Center,PIT,319.8289855,28,6,4,10,1.876002574
20182019,Teuvo Teravainen,Center,CAR,1384.45,82,21,55,76,3.293726751
20182019,Thomas Chabot,Defense,OTT,1102.866667,70,14,41,55,2.99220214
20182019,Thomas Hickey,Defense,NYI,1246.983333,40,0,4,4,0.192464481
20182019,Thomas Vanek,Right Wing,DET,1127.883333,64,16,20,36,1.915091691
20182019,Tim Gettinger,Left Wing,NYR,30.08333333,4,0,0,0,0
20182019,Tim Heed,Defense,SJS,464.7666667,37,2,11,13,1.678261493
20182019,Tim Schaller,Center,VAN,1088.416667,47,3,7,10,0.551259475
20182019,Timo Meier,Right Wing,SJS,1203.433333,78,30,36,66,3.29058527
20182019,TJ Brodie,Defense,CGY,1728.666667,79,9,25,34,1.18010027
20182019,Tobias Rieder,Right Wing,EDM,1144.916667,67,0,11,11,0.576461169
20182019,Tom Kuhnhackl,Right Wing,NYI,691.4833333,36,4,5,9,0.780929885
20182019,Tom Pyatt,Center,OTT,1138.966667,37,0,2,2,0.105358658
20182019,Tom Wilson,Right Wing,WSH,1247.15,63,22,18,40,1.924387604
20182019,Tomas Hertl,Center,SJS,1429.8,77,35,39,74,3.105329417
20182019,Tomas Hyka,Right Wing,VGK,120.6833333,17,1,3,4,1.988675597
20182019,Tomas Nosek,Left Wing,VGK,743.7833333,68,8,9,17,1.37136711
20182019,Tomas Plekanec,Center,MTL,1165.366667,3,1,0,1,0.051485941
20182019,Tomas Tatar,Left Wing,MTL,1335.75,80,25,33,58,2.605277934
20182019,Torey Krug,Defense,BOS,1550.133333,64,6,47,53,2.051436436
20182019,Travis Boyd,Center,WSH,70.6,53,5,15,20,16.99716714
20182019,Travis Dermott,Defense,TOR,591.7833333,64,4,13,17,1.723603796
20182019,Travis Hamonic,Defense,CGY,1532.816667,69,7,12,19,0.743728865
20182019,Travis Konecny,Center,PHI,1206.716667,82,24,25,49,2.436363134
20182019,Travis Sanheim,Defense,PHI,763.1666667,82,9,26,35,2.751692509
20182019,Travis Zajac,Center,NJD,1128.566667,80,19,27,46,2.445579939
20182019,Trent Frederic,Center,BOS,139.1923077,15,0,0,0,0
20182019,Trevor Carrick,Defense,CAR,7.783333333,1,0,0,0,0
20182019,Trevor Daley,Defense,DET,1594.166667,44,2,6,8,0.301097752
20182019,Trevor Lewis,Center,LAK,1035.5,44,3,9,12,0.695316272
20182019,Trevor Moore,Left Wing,TOR,225.8531746,25,2,6,8,2.125274532
20182019,Trevor Van Riemsdyk,Defense,CAR,1346.85,78,3,11,14,0.62367747
20182019,Troy Brouwer,Right Wing,FLA,1058.416667,75,12,9,21,1.190457444
20182019,Troy Stecher,Defense,VAN,1277.1,78,2,21,23,1.080573174
20182019,Troy Terry,Right Wing,ANA,20.41666667,32,4,9,13,38.20408163
20182019,Ty Rattie,Right Wing,EDM,216.9,50,4,7,11,3.042876902
20182019,Tyler Bertuzzi,Left Wing,DET,690.9666667,73,21,26,47,4.081238844
20182019,Tyler Bozak,Center,STL,1266.05,72,13,25,38,1.800876743
20182019,Tyler Ennis,Left Wing,TOR,874.0833333,51,12,6,18,1.235580132
20182019,Tyler Johnson,Center,TBL,1375.05,80,29,18,47,2.050834515
20182019,Tyler Lewington,Defense,WSH,27.58333333,2,1,1,2,4.350453172
20182019,Tyler Motte,Center,VAN,515.1666667,74,9,7,16,1.863474604
20182019,Tyler Myers,Defense,WPG,1757.333333,80,9,22,31,1.058421851
20182019,Tyler Pitlick,Right Wing,DAL,1091.416667,47,8,4,12,0.659693059
20182019,Tyler Seguin,Center,DAL,1712.5,82,33,47,80,2.802919708
20182019,Tyler Toffoli,Right Wing,LAK,1319.466667,82,13,21,34,1.546079224
20182019,Tyrell Goulbourne,Left Wing,PHI,50.25,2,0,0,0,0
20182019,Tyson Barrie,Defense,COL,1542.166667,78,14,45,59,2.295471739
20182019,Tyson Jost,Center,COL,951.1333333,70,11,15,26,1.640148595
20182019,Urho Vaakanainen,Defense,BOS,18.2,2,0,0,0,0
20182019,Valentin Zykov,Left Wing,CAR/EDM/VGK,137.0666667,28,2,3,5,2.188715953
20182019,Valeri Nichushkin,Right Wing,DAL,687.3953704,57,0,10,10,0.872860112
20182019,Valtteri Filppula,Center,NYI,1335.5,72,17,14,31,1.392736803
20182019,Victor Hedman,Defense,TBL,1990.85,70,12,42,54,1.627445563
20182019,Victor Mete,Defense,MTL,763.7333333,71,0,13,13,1.021298883
20182019,Victor Rask,Center,CAR/MIN,1090.833333,49,3,6,9,0.495034377
20182019,Viktor Arvidsson,Right Wing,NSH,1383.633333,58,34,14,48,2.081476306
20182019,Vince Dunn,Defense,STL,1292.3,78,12,23,35,1.625009673
20182019,Vincent Trocheck,Center,FLA,1752.466667,55,10,24,34,1.164073496
20182019,Vinni Lettieri,Right Wing,NYR,231.5166667,27,1,2,3,0.777481823
20182019,Vinnie Hinostroza,Center,ARI,691.0833333,72,16,23,39,3.385988183
20182019,Vitaly Abramov,Left Wing,OTT,13.86666667,1,0,0,0,0
20182019,Vladimir Sobotka,Left Wing,BUF,1387.416667,69,5,8,13,0.562195928
20182019,Vladimir Tarasenko,Right Wing,STL,1524.3,76,33,35,68,2.676638457
20182019,Vladislav Kamenev,Left Wing,COL,26.46666667,23,2,3,5,11.33501259
20182019,Vladislav Namestnikov,Center,NYR,1382.233333,78,11,20,31,1.345648347
20182019,Wade Megan,Center,DET,8.35,11,0,1,1,7.185628743
20182019,Warren Foegele,Left Wing,CAR,23.85,77,10,5,15,37.73584906
20182019,Wayne Simmonds,Right Wing,PHI/NSH,1356.55,79,17,13,30,1.326895433
20182019,Will Butcher,Defense,NJD,1300.816667,78,4,26,30,1.383746108
20182019,William Carrier,Center,VGK,328.4,54,8,1,9,1.644336175
20182019,William Karlsson,Center,VGK,1533.633333,82,24,32,56,2.190875698
20182019,William Nylander,Center,TOR,1367.416667,54,7,20,27,1.184715705
20182019,Xavier Ouellet,Defense,MTL,625.75,19,0,3,3,0.287654814
20182019,Yanni Gourde,Center,TBL,1325.5,80,22,26,48,2.172764994
20182019,Yannick Weber,Defense,NSH,567.2,62,2,6,8,0.846262341
20182019,Yegor Yakovlev,Defense,NJD,389.6701389,25,2,5,7,1.077834707
20182019,Zac Dalpe,Center,CBJ,88.85,1,0,1,1,0.675295442
20182019,Zac Rinaldo,Center,NSH,599.55,23,1,2,3,0.300225169
20182019,Zach Aston-Reese,Right Wing,PIT,184.6666667,43,8,9,17,5.523465704
20182019,Zach Bogosian,Defense,BUF,345.3333333,65,3,16,19,3.301158301
20182019,Zach Hyman,Right Wing,TOR,1422.183333,71,21,20,41,1.729734797
20182019,Zach Parise,Left Wing,MIN,718.5833333,74,28,33,61,5.093354981
20182019,Zach Sanford,Left Wing,STL,767.5636364,60,8,12,20,1.563388289
20182019,Zach Trotman,Defense,PIT,38.35,13,0,1,1,1.564537158
20182019,Zach Werenski,Defense,CBJ,1739.283333,82,11,33,44,1.517866554
20182019,Zack Kassian,Right Wing,EDM,862.7666667,79,15,11,26,1.808136615
20182019,Zack MacEwen,Right Wing,VAN,28.73333333,4,0,1,1,2.088167053
20182019,Zack Smith,Center,OTT,1137.116667,70,9,19,28,1.477420962
20182019,Zdeno Chara,Defense,BOS,1671.966667,62,5,9,14,0.50240236
20182019,Zemgus Girgensons,Center,BUF,972.6666667,72,5,13,18,1.110349554
20172018,A.J. Greer,Left Wing,COL,94.01666667,17,0,3,3,1.914554157
20172018,Aaron Ekblad,Defense,FLA,1939.15,82,16,22,38,1.17577289
20172018,Aaron Ness,Defense,WSH,101.8166667,8,0,1,1,0.589294484
20172018,Adam Clendening,Defense,ARI,42.61666667,5,0,2,2,2.815799765
20172018,Adam Cracknell,Right Wing,DAL/NYR,20.86666667,5,0,0,0,0
20172018,Adam Erne,Left Wing,TBL,685.6166667,23,3,1,4,0.350049833
20172018,Adam Gaudette,Center,VAN,615.7833333,5,0,0,0,0
20172018,Adam Henrique,Center,NJD/ANA,1348.05,81,24,26,50,2.225436742
20172018,Adam Larsson,Defense,EDM,1775.616667,63,4,9,13,0.439284005
20172018,Adam Lowry,Left Wing,WPG,1141.6,45,8,13,21,1.103714085
20172018,Adam McQuaid,Defense,BOS,789.4166667,38,1,3,4,0.304021957
20172018,Adam Pelech,Defense,NYI,1452.883333,78,3,16,19,0.784646622
20172018,Adrian Kempe,Center,LAK,1174.266667,81,16,21,37,1.890541615
20172018,Alan Quine,Center,NYI,123.4666667,21,0,3,3,1.457883369
20172018,Alec Martinez,Defense,LAK,1281.066667,77,9,16,25,1.170899251
20172018,Aleksander Barkov,Center,FLA,1833.116667,79,27,51,78,2.553028994
20172018,Ales Hemsky,Right Wing,MTL,69.45,7,0,0,0,0
20172018,Alex Biega,Defense,VAN,726.4333333,44,1,8,9,0.743357959
20172018,Alex Broadhurst,Center,CBJ,20.08333333,2,0,0,0,0
20172018,Alex Burrows,Right Wing,OTT,831.0666667,71,6,8,14,1.010749238
20172018,Alex Chiasson,Right Wing,WSH,1238.8,61,9,9,18,0.87181143
20172018,Alex DeBrincat,Center,CHI,1452.05,82,28,24,52,2.14868634
20172018,Alex Formenton,Left Wing,OTT,104.7833333,1,0,0,0,0
20172018,Alex Galchenyuk,Center,MTL,1132.75,82,19,32,51,2.701390422
20172018,Alex Goligoski,Defense,ARI,1583.15,78,12,23,35,1.326469381
20172018,Alex Iafallo,Center,LAK,1382.533333,75,9,16,25,1.084964799
20172018,Alex Killorn,Center,TBL,1221.25,82,15,32,47,2.309109519
20172018,Alex Ovechkin,Right Wing,WSH,1694.966667,82,49,38,87,3.079706582
20172018,Alex Petrovic,Defense,FLA,578.2166667,67,2,11,13,1.348975298
20172018,Alex Pietrangelo,Defense,STL,1709.183333,78,15,39,54,1.895642168
20172018,Alex Tuch,Center,VGK,1238.15,78,15,22,37,1.792997617
20172018,Alexander Burmistrov,Center,VAN,287.65,24,2,4,6,1.251520946
20172018,Alexander Edler,Defense,VAN,1377.183333,70,6,28,34,1.481284264
20172018,Alexander Kerfoot,Center,COL,1161.9,79,19,24,43,2.220500904
20172018,Alexander Nylander,Left Wing,BUF,146.3166667,3,1,0,1,0.410069484
20172018,Alexander Radulov,Right Wing,DAL,1384.516667,82,27,45,72,3.12022246
20172018,Alexander Steen,Left Wing,STL,1029.933333,76,15,31,46,2.679785099
20172018,Alexander Wennberg,Center,CBJ,1131.116667,66,8,27,35,1.856572414
20172018,Alexei Emelin,Defense,NSH,1283.083333,76,1,8,9,0.420861207
20172018,Anders Bjork,Left Wing,BOS,236,30,4,8,12,3.050847458
20172018,Anders Lee,Center,NYI,1401.3,82,40,22,62,2.654677799
20172018,Andre Burakovsky,Left Wing,WSH,845.5333333,56,12,13,25,1.774028227
20172018,Andreas Athanasiou,Center,DET,1291,71,16,17,33,1.53369481
20172018,Andreas Borgman,Defense,TOR,655.7166667,48,3,8,11,1.006532293
20172018,Andreas Englund,Defense,OTT,40,1,0,0,0,0
20172018,Andreas Johnsson,Left Wing,TOR,997.9,9,2,1,3,0.180378795
20172018,Andreas Martinsen,Left Wing,CHI,190.35,9,1,0,1,0.315208826
20172018,Andrei Mironov,Defense,COL,110.4666667,10,1,2,3,1.629450815
20172018,Andrej Sekera,Defense,EDM,396.1333333,36,0,8,8,1.211713228
20172018,Andrej Sustr,Defense,TBL,60.2,44,2,5,7,6.976744186
20172018,Andrew Cogliano,Center,ANA,981.3,80,12,23,35,2.140018343
20172018,Andrew Copp,Center,WPG,839.0833333,82,9,19,28,2.002184924
20172018,Andrew Crescenzi,Center,LAK,15.71666667,2,0,0,0,0
20172018,Andrew Ladd,Left Wing,NYI,359.9,73,12,17,29,4.834676299
20172018,Andrew MacDonald,Defense,PHI,770.55,66,6,15,21,1.635195639
20172018,Andrew Mangiapane,Left Wing,CGY,464.9333333,10,0,0,0,0
20172018,Andrew Shaw,Right Wing,MTL,1001.866667,51,10,10,20,1.197764174
20172018,Andy Andreoff,Left Wing,LAK,422.4333333,45,3,6,9,1.278308214
20172018,Andy Greene,Defense,NJD,1707.683333,81,3,10,13,0.456759157
20172018,Andy Welinski,Defense,ANA,416.8333333,7,0,2,2,0.287884846
20172018,Anthony Beauvillier,Center,NYI,1186.15,71,21,15,36,1.821017578
20172018,Anthony Bitetto,Defense,NSH,429.2833333,32,1,2,3,0.41930349
20172018,Anthony Cirelli,Center,TBL,1218.5,18,5,6,11,0.541649569
20172018,Anthony DeAngelo,Defense,NYR,1177.8,32,0,8,8,0.40753948
20172018,Anthony Duclair,Left Wing,ARI/CHI,940.4166667,56,11,12,23,1.467434648
20172018,Anthony Mantha,Left Wing,DET,1190.9,80,24,24,48,2.418339071
20172018,Anthony Peluso,Right Wing,WSH,16.45,2,0,0,0,0
20172018,Antoine Roussel,Left Wing,DAL,890.9166667,73,5,12,17,1.144888224
20172018,Antoine Vermette,Center,ANA,880.7333333,64,8,8,16,1.090000757
20172018,Anton Blidh,Left Wing,BOS,13.76666667,1,0,0,0,0
20172018,Anton Lindholm,Defense,COL,14.25,48,0,4,4,16.84210526
20172018,Anton Slepyshev,Left Wing,EDM,590.9166667,50,6,6,12,1.218445917
20172018,Anton Stralman,Defense,TBL,964.35,80,4,14,18,1.119925338
20172018,Anze Kopitar,Center,LAK,1808.15,82,35,57,92,3.052844067
20172018,Artem Anisimov,Center,CHI,1274.15,72,20,11,31,1.459796727
20172018,Artemi Panarin,Left Wing,CBJ,1568.75,81,27,55,82,3.13625498
20172018,Artturi Lehkonen,Left Wing,MTL,1274.483333,66,12,9,21,0.988635918
20172018,Ashton Sautner,Defense,VAN,247.2166667,5,0,2,2,0.485404166
20172018,Austin Czarnik,Center,BOS,612.2,10,0,4,4,0.392028749
20172018,Austin Watson,Center,NSH,535.3333333,76,14,5,19,2.129514321
20172018,Auston Matthews,Center,TOR,1262.633333,62,34,29,63,2.993743235
20172018,Barclay Goodrow,Right Wing,SJS,903.3333333,47,7,7,14,0.929889299
20172018,Beau Bennett,Right Wing,STL,64.78333333,6,0,0,0,0
20172018,Ben Chiarot,Defense,WPG,1449.5,57,2,12,14,0.579510176
20172018,Ben Harpur,Defense,OTT,899.2833333,41,0,1,1,0.066719795
20172018,Ben Hutton,Defense,VAN,1542.316667,61,0,6,6,0.233415101
20172018,Ben Lovejoy,Defense,NJD,1212.05,57,2,6,8,0.396023266
20172018,Ben Sexton,Center,OTT,20.55,2,0,0,0,0
20172018,Benoit Pouliot,Left Wing,BUF,1012.6,74,13,6,19,1.125814734
20172018,Blake Coleman,Center,NJD,1327.45,79,13,12,25,1.129986064
20172018,Blake Comeau,Left Wing,COL,1210.933333,79,13,21,34,1.684650958
20172018,Blake Hillman,Defense,CHI,72.11666667,4,1,0,1,0.831985209
20172018,Blake Pietila,Left Wing,NJD,252.1166667,2,0,0,0,0
20172018,Blake Wheeler,Right Wing,WPG,1701.033333,81,23,68,91,3.209813643
20172018,Bo Horvat,Center,VAN,1705.166667,64,22,22,44,1.548235754
20172018,Bobby Ryan,Right Wing,OTT,1221.6,62,11,22,33,1.620825147
20172018,Boo Nieves,Center,NYR,415.2,28,1,8,9,1.300578035
20172018,Boone Jenner,Center,CBJ,1312.25,75,13,19,32,1.463135835
20172018,Brad Hunt,Defense,VGK,624.4166667,45,3,15,18,1.729614307
20172018,Brad Malone,Center,EDM,143.1833333,7,0,0,0,0
20172018,Brad Marchand,Left Wing,BOS,1548.766667,68,34,51,85,3.292942772
20172018,Brad Richardson,Right Wing,ARI,1052.566667,76,3,12,15,0.855052728
20172018,Brady Skjei,Defense,NYR,1655.433333,82,4,21,25,0.906107162
20172018,Brandon Carlo,Defense,BOS,1507.05,76,0,6,6,0.238877277
20172018,Brandon Davidson,Defense,MTL/EDM/NYI,137.9333333,51,4,3,7,3.044949251
20172018,Brandon Dubinsky,Center,CBJ,754.0666667,62,6,10,16,1.273096985
20172018,Brandon Manning,Defense,PHI,580.1833333,65,7,12,19,1.964896154
20172018,Brandon Montour,Defense,ANA,1839.933333,80,9,23,32,1.043516069
20172018,Brandon Pirri,Center,VGK,448.8333333,2,3,0,3,0.401039733
20172018,Brandon Saad,Left Wing,CHI,1414.35,82,18,17,35,1.484780995
20172018,Brandon Sutter,Center,VAN,454.0333333,61,11,15,26,3.435871081
20172018,Brandon Tanev,Center,WPG,1126.733333,61,8,10,18,0.958523164
20172018,Brayden McNabb,Defense,VGK,1579.216667,76,5,10,15,0.5699028
20172018,Brayden Point,Center,TBL,1494.8,82,32,34,66,2.649183837
20172018,Brayden Schenn,Center,STL,1335.616667,82,28,42,70,3.144614847
20172018,Braydon Coburn,Defense,TBL,1192.783333,72,1,14,15,0.754537706
20172018,Brendan Gallagher,Right Wing,MTL,1344.35,82,31,23,54,2.410086659
20172018,Brendan Gaunce,Left Wing,VAN,22.83333333,37,4,2,6,15.76642336
20172018,Brendan Guhle,Defense,BUF,119.7833333,18,0,5,5,2.504522054
20172018,Brendan Leipsic,Left Wing,VGK/VAN,857.8,58,5,17,22,1.538820238
20172018,Brendan Lemieux,Left Wing,WPG,570.1333333,9,1,0,1,0.105238541
20172018,Brendan Perlini,Left Wing,ARI,788.4333333,74,17,13,30,2.283008498
20172018,Brendan Smith,Defense,NYR,962.8333333,44,1,7,8,0.498528648
20172018,Brenden Dillon,Defense,SJS,1454.616667,81,5,17,22,0.907455572
20172018,Brent Burns,Defense,SJS,2058.933333,82,12,55,67,1.952467297
20172018,Brent Seabrook,Defense,CHI,1488.25,81,7,19,26,1.048210986
20172018,Brett Connolly,Right Wing,WSH,1079.633333,70,15,12,27,1.500509432
20172018,Brett Kulak,Defense,CGY,1017.116667,71,2,6,8,0.471922264
20172018,Brett Lernout,Defense,MTL,300.1166667,18,0,1,1,0.199922252
20172018,Brett Pesce,Defense,CAR,1494.833333,65,3,16,19,0.762626826
20172018,Brett Ritchie,Right Wing,DAL,509.1166667,71,7,7,14,1.649916522
20172018,Brian Boyle,Center,NJD,980.2666667,69,13,10,23,1.407780196
20172018,Brian Dumoulin,Defense,PIT,1596.716667,80,5,13,18,0.676388005
20172018,Brian Gibbons,Center,NJD,699.35,59,12,14,26,2.23064274
20172018,Brian Gionta,Right Wing,BOS,260.3,20,2,5,7,1.613522858
20172018,Brian Lashoff,Defense,DET,54.11666667,1,0,0,0,0
20172018,Brock Boeser,Right Wing,VAN,1320.466667,62,29,26,55,2.499116474
20172018,Brock McGinn,Left Wing,CAR,1172.95,80,16,14,30,1.534592267
20172018,Brock Nelson,Center,NYI,1473.316667,82,19,16,35,1.42535549
20172018,Brooks Laich,Center,LAK,134.2166667,12,0,1,1,0.447038371
20172018,Brooks Orpik,Defense,WSH,830.7666667,81,0,10,10,0.722224451
20172018,Bryan Little,Center,WPG,1298.966667,82,16,27,43,1.986194154
20172018,Bryan Rust,Right Wing,PIT,1144.366667,69,13,25,38,1.992368413
20172018,Byron Froese,Center,MTL,555.9,48,3,8,11,1.187263896
20172018,Cal Clutterbuck,Right Wing,NYI,1019.666667,76,8,10,18,1.059169663
20172018,Cal O'Reilly,Center,MIN,8.15,1,0,0,0,0
20172018,Calle Jarnkrok,Center,NSH,1219.083333,68,16,19,35,1.722605783
20172018,Calle Rosen,Defense,TOR,66.81666667,4,0,1,1,0.897979546
20172018,Calvin De Haan,Defense,NYI,1369.533333,33,1,11,12,0.525726525
20172018,Cam Atkinson,Right Wing,CBJ,1550.15,65,24,22,46,1.780472857
20172018,Cam Fowler,Defense,ANA,1379.583333,67,8,24,32,1.391724555
20172018,Carl Dahlstrom,Defense,CHI,708.1166667,11,0,3,3,0.254195401
20172018,Carl Gunnarsson,Defense,STL,398.3666667,63,5,4,9,1.355535102
20172018,Carl Hagelin,Left Wing,PIT,854.25,81,10,21,31,2.177348551
20172018,Carl Soderberg,Center,COL,1429.916667,77,16,21,37,1.552538027
20172018,Carson Soucy,Defense,MIN,44.5,3,0,0,0,0
20172018,Carter Rowney,Right Wing,PIT,778.8,44,2,3,5,0.385208012
20172018,Casey Cizikas,Center,NYI,1023.516667,64,7,10,17,0.996564133
20172018,Casey Mittelstadt,Center,BUF,1035.783333,6,1,4,5,0.289635863
20172018,Casey Nelson,Defense,BUF,585.55,37,3,5,8,0.819742123
20172018,Cedric Paquette,Center,TBL,961.7666667,56,5,4,9,0.561466745
20172018,Chad Ruhwedel,Defense,PIT,293.7833333,44,2,3,5,1.021160719
20172018,Chandler Stephenson,Center,WSH,774.9166667,67,6,12,18,1.393698247
20172018,Charles Hudon,Left Wing,MTL,373.4833333,72,10,20,30,4.819492168
20172018,Charlie Coyle,Center,MIN,1358.866667,66,11,26,37,1.63371437
20172018,Charlie McAvoy,Defense,BOS,1196.166667,63,7,25,32,1.605127491
20172018,Chase Balisy,Right Wing,FLA,78.53333333,8,0,0,0,0
20172018,Chris Bigras,Defense,COL,207.8333333,15,0,1,1,0.288692863
20172018,Chris Butler,Defense,STL,182.5,6,0,0,0,0
20172018,Chris DiDomenico,Center,OTT,281.3833333,24,6,4,10,2.132322455
20172018,Chris Kelly,Center,ANA,91.95,12,0,2,2,1.305057096
20172018,Chris Kreider,Left Wing,NYR,1373.133333,58,16,21,37,1.616740302
20172018,Chris Kunitz,Left Wing,TBL,509.0666667,82,13,16,29,3.418019906
20172018,Chris Stewart,Right Wing,MIN/CGY,580.3166667,54,10,6,16,1.654269221
20172018,Chris Thorburn,Right Wing,STL,1.866666667,50,1,6,7,225
20172018,Chris Tierney,Center,SJS,1379.65,82,17,23,40,1.73957163
20172018,Chris Wagner,Right Wing,ANA/NYI,1020.583333,79,7,9,16,0.940638524
20172018,Chris Wideman,Defense,OTT,326.3,16,3,5,8,1.471038921
20172018,Christian Djoos,Defense,WSH,610.1333333,63,3,11,14,1.376748252
20172018,Christian Dvorak,Center,ARI,287.7166667,78,15,22,37,7.715924231
20172018,Christian Fischer,Right Wing,ARI,937.2833333,79,15,18,33,2.112488219
20172018,Christian Folin,Defense,LAK,704.7833333,65,3,10,13,1.106723106
20172018,Christian Jaros,Defense,OTT,876.45,2,0,0,0,0
20172018,Christian Wolanin,Defense,OTT,519.7666667,10,1,2,3,0.346309241
20172018,Christoph Bertschy,Center,MIN,5.383333333,1,0,0,0,0
20172018,Christopher Tanev,Defense,VAN,1107.166667,42,2,9,11,0.596116213
20172018,Claude Giroux,Center,PHI,1759.1,82,34,68,102,3.479051788
20172018,Clayton Keller,Center,ARI,1494.033333,82,23,42,65,2.610383526
20172018,Cody Ceci,Defense,OTT,1669.416667,82,5,14,19,0.682873259
20172018,Cody Eakin,Center,VGK,1200.266667,80,11,16,27,1.349700067
20172018,Cody Franson,Defense,CHI,380.55,23,1,6,7,1.103665747
20172018,Cody McLeod,Left Wing,NSH/NYR,246.4833333,48,1,3,4,0.973696666
20172018,Colby Cave,Center,BOS,652.45,3,0,0,0,0
20172018,Colin Miller,Defense,VGK,1275.95,82,10,31,41,1.927975234
20172018,Colin White,Center,OTT,1151.1,21,2,4,6,0.312744332
20172018,Colin Wilson,Center,COL,881.9666667,56,6,12,18,1.224536075
20172018,Colton Parayko,Defense,STL,1821.716667,82,6,29,35,1.152758845
20172018,Colton Sceviour,Center,FLA,725.6,76,11,13,24,1.984564498
20172018,Colton Sissons,Center,NSH,1202.183333,81,9,18,27,1.347548211
20172018,Connor Brickley,Center,FLA,125.65,44,4,8,12,5.730202945
20172018,Connor Brown,Right Wing,TOR,1131.366667,82,14,14,28,1.484929731
20172018,Connor Carrick,Defense,TOR,571.1333333,47,4,8,12,1.260651337
20172018,Connor McDavid,Center,EDM,1782.366667,82,41,67,108,3.635615567
20172018,Connor Murphy,Defense,CHI,1014.516667,76,2,12,14,0.827980483
20172018,Conor Sheary,Left Wing,PIT,1140.5,79,18,12,30,1.578255151
20172018,Corey Perry,Right Wing,ANA,459.6333333,71,17,32,49,6.39640293
20172018,Cory Conacher,Center,TBL,8.583333333,36,8,4,12,83.88349515
20172018,Craig Smith,Center,NSH,1149.983333,79,25,26,51,2.660908129
20172018,Curtis Lazar,Center,CGY,4.8,65,2,10,12,150
20172018,Curtis Mckenzie,Left Wing,DAL,56.71666667,7,0,2,2,2.115780194
20172018,Curtis Valk,Center,FLA,3.416666667,1,0,0,0,0
20172018,Dakota Mermis,Defense,ARI,11.33333333,9,0,0,0,0
20172018,Dale Weise,Right Wing,PHI,600.6166667,46,4,4,8,0.799178622
20172018,Dalton Prout,Defense,NJD,262.1666667,4,0,0,0,0
20172018,Damon Severson,Defense,NJD,1810.9,76,9,15,24,0.795184715
20172018,Dan Girardi,Defense,TBL,1104.766667,77,6,12,18,0.977581993
20172018,Dan Hamhuis,Defense,DAL,915.5666667,80,3,21,24,1.572796447
20172018,Danick Martel,Center,PHI,91.6,4,0,0,0,0
20172018,Daniel Brickley,Defense,LAK,51.23333333,1,0,1,1,1.171112557
20172018,Daniel Carr,Left Wing,MTL,59.71666667,38,6,10,16,16.07591404
20172018,Daniel Catenacci,Center,NYR,11.05,1,0,0,0,0
20172018,Daniel O'Regan,Center,SJS/BUF,11.93333333,21,0,4,4,20.11173184
20172018,Daniel Sedin,Left Wing,VAN,1234.766667,81,23,32,55,2.672569716
20172018,Daniel Sprong,Right Wing,PIT,753.8166667,8,2,1,3,0.23878485
20172018,Daniel Winnik,Center,MIN,1097.6,81,6,17,23,1.25728863
20172018,Danny Dekeyser,Defense,DET,1141.783333,65,6,6,12,0.630592494
20172018,Danton Heinen,Center,BOS,1074,77,16,31,47,2.625698324
20172018,Darnell Nurse,Defense,EDM,1949.883333,82,6,20,26,0.800047866
20172018,Darren Archibald,Left Wing,VAN,88.78333333,27,4,5,9,6.082222639
20172018,Darren Helm,Center,DET,888.6833333,75,13,18,31,2.092984003
20172018,David Backes,Center,BOS,912.8666667,57,14,19,33,2.168991455
20172018,David Booth,Left Wing,DET,195.3,28,4,1,5,1.53609831
20172018,David Desharnais,Center,NYR,926.7333333,71,6,22,28,1.812819222
20172018,David Kampf,Right Wing,CHI,880.2333333,46,4,7,11,0.749801189
20172018,David Krejci,Center,BOS,1433.366667,64,17,27,44,1.841817632
20172018,David Pastrnak,Right Wing,BOS,1237.2,82,35,45,80,3.879728419
20172018,David Perron,Left Wing,VGK,973.2833333,70,16,50,66,4.068702159
20172018,David Savard,Defense,CBJ,1619.066667,81,4,12,16,0.592934201
20172018,David Schlemko,Defense,MTL,357.2,37,1,4,5,0.839865622
20172018,David Warsofsky,Defense,COL,214.2666667,16,0,5,5,1.400124456
20172018,Dean Kukan,Defense,CBJ,336.6666667,11,0,4,4,0.712871287
20172018,Denis Malgin,Center,FLA,644.7666667,51,11,11,22,2.047252236
20172018,Dennis Rasmussen,Center,ANA,240.8833333,27,1,3,4,0.996332941
20172018,Dennis Seidenberg,Defense,NYI,500.85,28,0,5,5,0.598981731
20172018,Derek Dorsett,Right Wing,VAN,305.4333333,20,7,2,9,1.767979919
20172018,Derek Forbort,Defense,LAK,1680.333333,78,1,17,18,0.642729617
20172018,Derek Grant,Center,ANA,653.8166667,66,12,12,24,2.202452267
20172018,Derek MacKenzie,Center,FLA,2.716666667,75,3,11,14,309.202454
20172018,Derek Ryan,Center,CAR,1119.116667,80,15,23,38,2.037321101
20172018,Derek Stepan,Center,ARI,1382.083333,82,14,42,56,2.431112451
20172018,Derick Brassard,Center,OTT/PIT,1049.216667,72,21,25,46,2.63053389
20172018,Derrick Pouliot,Defense,VAN,1063.866667,71,3,19,22,1.240756987
20172018,Deryk Engelland,Defense,VGK,1469.416667,79,5,18,23,0.939148188
20172018,Devante Smith-Pelly,Right Wing,WSH,586.5,75,7,9,16,1.636828645
20172018,Devin Shore,Center,DAL,1083.033333,82,11,21,32,1.772798621
20172018,Dillon Heatherington,Defense,DAL,50.93333333,6,0,1,1,1.178010471
20172018,Dion Phaneuf,Defense,OTT/LAK,1002.233333,79,6,20,26,1.556523764
20172018,Dmitrij Jaskin,Right Wing,STL,372.85,76,6,11,17,2.735684592
20172018,Dmitry Kulikov,Defense,WPG,892.7833333,62,3,8,11,0.739261112
20172018,Dmitry Orlov,Defense,WSH,1774.166667,82,10,21,31,1.048379521
20172018,Dominic Moore,Center,TOR,513.0666667,50,6,6,12,1.403326403
20172018,Dominic Toninato,Center,COL,13.4,37,0,2,2,8.955223881
20172018,Dominic Turgeon,Center,DET,50.35,5,0,0,0,0
20172018,Dominik Simon,Center,PIT,946.4,33,4,8,12,0.760777684
20172018,Dougie Hamilton,Defense,CGY,1615.35,82,17,27,44,1.634320735
20172018,Drake Caggiula,Center,EDM,794.2333333,67,13,7,20,1.510891006
20172018,Drew Doughty,Defense,LAK,2180.25,82,10,50,60,1.651186791
20172018,Drew Stafford,Right Wing,NJD,699.2833333,59,8,7,15,1.287031961
20172018,Dryden Hunt,Center,FLA,342.9333333,11,0,1,1,0.17496112
20172018,Duncan Keith,Defense,CHI,1886.816667,82,2,30,32,1.017586941
20172018,Duncan Siemens,Defense,COL,197.1,16,1,1,2,0.608828006
20172018,Dustin Brown,Right Wing,LAK,1468.25,81,28,33,61,2.492763494
20172018,Dustin Byfuglien,Defense,WPG,1023.366667,69,8,37,45,2.638350542
20172018,Dylan DeMelo,Defense,SJS,1485.416667,63,0,20,20,0.807854137
20172018,Dylan Gambrell,Center,SJS,69.1,3,0,0,0,0
20172018,Dylan Larkin,Center,DET,1657.583333,82,16,47,63,2.280428334
20172018,Dylan Sikura,Right Wing,CHI,371.95,5,0,3,3,0.483936013
20172018,Dylan Strome,Center,ARI,1258.833333,21,4,5,9,0.428968622
20172018,Eeli Tolvanen,Left Wing,NSH,53.08333333,3,0,0,0,0
20172018,Elias Lindholm,Center,CAR,1623.133333,81,16,28,44,1.626483756
20172018,Eric Fehr,Right Wing,TOR/SJS,794.7166667,18,3,1,4,0.301994421
20172018,Eric Gryba,Defense,EDM,152.95,21,0,2,2,0.784570121
20172018,Eric Robinson,Left Wing,CBJ,153.8333333,1,0,0,0,0
20172018,Eric Staal,Center,MIN,1467.233333,82,42,34,76,3.107890133
20172018,Erik Burgdoerfer,Defense,OTT,42.68333333,2,0,1,1,1.405700898
20172018,Erik Gudbranson,Defense,VAN,1386.316667,52,2,3,5,0.216400774
20172018,Erik Gustafsson,Defense,CHI,1782.616667,35,5,11,16,0.538534177
20172018,Erik Haula,Center,VGK,250.25,76,29,26,55,13.18681319
20172018,Erik Johnson,Defense,COL,1744.883333,62,9,16,25,0.859656329
20172018,Erik Karlsson,Defense,OTT,1297.833333,71,9,53,62,2.866315654
20172018,Esa Lindell,Defense,DAL,1994.083333,80,7,20,27,0.81240336
20172018,Ethan Bear,Defense,EDM,335.7166667,18,1,3,4,0.714888547
20172018,Evan Rodrigues,Right Wing,BUF,1170.016667,48,7,18,25,1.282033019
20172018,Evander Kane,Left Wing,BUF/SJS,1381.383333,78,29,25,54,2.345474947
20172018,Evgeni Malkin,Center,PIT,1277.766667,78,42,56,98,4.601779146
20172018,Evgeny Dadonov,Left Wing,FLA,1506.6,74,28,37,65,2.588610115
20172018,Evgeny Kuznetsov,Center,WSH,1428.583333,79,27,56,83,3.48597095
20172018,Evgeny Svechnikov,Left Wing,DET,122.7,14,2,2,4,1.95599022
20172018,Filip Chlapik,Center,OTT,69.31666667,20,1,3,4,3.462370762
20172018,Filip Chytil,Center,NYR,1034.116667,9,1,2,3,0.174061598
20172018,Filip Forsberg,Center,NSH,1191.383333,67,26,38,64,3.223143964
20172018,Francois Beauchemin,Defense,ANA,1159,67,3,14,17,0.880069025
20172018,Frank Corrado,Defense,PIT,57.5,5,0,0,0,0
20172018,Frank Vatrano,Center,BOS/FLA,1187.95,41,7,3,10,0.505071762
20172018,Frans Nielsen,Center,DET,1200.216667,79,16,17,33,1.649702137
20172018,Freddie Hamilton,Center,CGY/ARI,143.9166667,16,0,1,1,0.416907933
20172018,Frederick Gaudreau,Center,NSH,496.7,20,0,3,3,0.362391786
20172018,Frederik Gauthier,Center,TOR,585.7333333,9,1,0,1,0.102435693
20172018,Fredrik Claesson,Defense,OTT,638.1833333,64,1,6,7,0.658118096
20172018,Gabriel Bourque,Left Wing,COL,536.7333333,58,5,6,11,1.229660912
20172018,Gabriel Carlsson,Defense,CBJ,9.35,14,0,2,2,12.8342246
20172018,Gabriel Dumont,Left Wing,TBL/OTT,270.3833333,30,1,1,2,0.443814338
20172018,Gabriel Landeskog,Left Wing,COL,1543.533333,78,25,37,62,2.410054853
20172018,Garnet Hathaway,Right Wing,CGY,799.9833333,59,4,9,13,0.975020313
20172018,Gemel Smith,Center,DAL,142.25,46,6,5,11,4.639718805
20172018,Giovanni Fiore,Right Wing,ANA,7.883333333,1,0,0,0,0
20172018,Greg McKegg,Center,PIT,437.4,26,2,2,4,0.548696845
20172018,Greg Pateryn,Defense,DAL,1369.733333,73,1,12,13,0.569453908
20172018,Gustav Forsling,Defense,CHI,733.8333333,41,3,10,13,1.062911651
20172018,Gustav Nyquist,Right Wing,DET,1425.083333,82,21,19,40,1.68411204
20172018,Gustav Olofsson,Defense,MIN,521.2333333,41,0,8,8,0.920892754
20172018,Hampus Lindholm,Defense,ANA,1825.25,69,13,18,31,1.019038488
20172018,Haydn Fleury,Defense,CAR,250.0666667,67,0,8,8,1.919488136
20172018,Henrik Borgstrom,Center,FLA,600.4333333,4,1,0,1,0.09992783
20172018,Henrik Haapala,Left Wing,FLA,68.48333333,5,0,1,1,0.876125578
20172018,Henrik Sedin,Center,VAN,1271.383333,82,3,47,50,2.359634519
20172018,Henrik Zetterberg,Left Wing,DET,1590.616667,82,11,45,56,2.112388277
20172018,Hudson Fasching,Right Wing,BUF,48.5,5,0,0,0,0
20172018,Ian Cole,Defense,PIT/CBJ,1401.45,67,5,15,20,0.856256021
20172018,Ian McCoshen,Defense,FLA,253.3833333,38,3,1,4,0.947181477
20172018,Iiro Pakarinen,Right Wing,EDM,407.5166667,40,2,1,3,0.441699726
20172018,Ivan Barbashev,Center,STL,921.0833333,53,7,6,13,0.846828915
20172018,Ivan Provorov,Defense,PHI,2057.333333,82,17,24,41,1.195722618
20172018,J.T. Brown,Right Wing,TBL/ANA,513.2333333,47,2,5,7,0.818341235
20172018,J.T. Compher,Left Wing,COL,1155.183333,69,13,10,23,1.194615573
20172018,J.T. Miller,Center,NYR/TBL,1100.783333,82,23,35,58,3.161385074
20172018,Jaccob Slavin,Defense,CAR,1891.083333,82,8,22,30,0.951835368
20172018,Jack Eichel,Center,BUF,1573.95,67,25,39,64,2.439721719
20172018,Jack Johnson,Defense,CBJ,1580.966667,77,3,8,11,0.417466107
20172018,Jack Rodewald,Right Wing,OTT,42.36666667,4,0,0,0,0
20172018,Jack Roslovic,Center,WPG,749.0833333,31,5,9,14,1.121370564
20172018,Jacob de la Rose,Center,MTL,686.45,55,4,8,12,1.048874645
20172018,Jacob Josefson,Center,BUF,443.4666667,39,2,2,4,0.541190619
20172018,Jacob Trouba,Defense,WPG,1876.633333,55,3,21,24,0.767331569
20172018,Jaden Schwartz,Left Wing,STL,1249.85,62,24,35,59,2.832339881
20172018,Jake DeBrusk,Left Wing,BOS,1098.35,70,16,27,43,2.348978012
20172018,Jake Dotchin,Defense,TBL,235.55,48,3,8,11,2.801952876
20172018,Jake Gardiner,Defense,TOR,1315.333333,82,5,47,52,2.372022301
20172018,Jake Guentzel,Left Wing,PIT,1585.666667,82,22,26,48,1.816270759
20172018,Jake McCabe,Defense,BUF,1117.733333,53,3,9,12,0.644160802
20172018,Jake Muzzin,Defense,LAK,1707.366667,74,8,34,42,1.475957127
20172018,Jake Virtanen,Right Wing,VAN,1040.533333,75,10,10,20,1.153254741
20172018,Jakob Chychrun,Defense,ARI,1073.933333,50,4,10,14,0.782171457
20172018,Jakob Silfverberg,Right Wing,ANA,1246.083333,77,17,23,40,1.926034909
20172018,Jakub Jerabek,Defense,MTL/WSH,7.866666667,36,2,6,8,61.01694915
20172018,Jakub Voracek,Right Wing,PHI,1456.816667,82,20,65,85,3.500783672
20172018,Jakub Vrana,Left Wing,WSH,1151.85,73,13,14,27,1.406433129
20172018,James Neal,Left Wing,VGK,943,71,25,19,44,2.799575822
20172018,James Van Riemsdyk,Left Wing,TOR,1095.716667,81,36,18,54,2.956968803
20172018,Jamie Benn,Left Wing,DAL,1420.933333,82,36,43,79,3.335835601
20172018,Jamie McGinn,Left Wing,FLA,202.8666667,76,13,16,29,8.57706211
20172018,Jamie Oleksiak,Defense,DAL/PIT,839.6166667,68,5,12,17,1.214840106
20172018,Jan Rutta,Defense,CHI,578.3333333,57,6,14,20,2.074927954
20172018,Janne Kuokkanen,Left Wing,CAR,76.43333333,4,0,0,0,0
20172018,Jannik Hansen,Right Wing,SJS,554.0833333,46,2,12,14,1.516017446
20172018,Jared Boll,Right Wing,ANA,44.25,10,1,0,1,1.355932203
20172018,Jared McCann,Center,FLA,1131.766667,68,9,19,28,1.484404913
20172018,Jared Spurgeon,Defense,MIN,1979.9,61,9,28,37,1.121268751
20172018,Jaromir Jagr,Right Wing,CGY,285.15,22,1,6,7,1.472908995
20172018,Jason Chimera,Left Wing,NYI/ANA,763.7,74,3,10,13,1.021343459
20172018,Jason Demers,Defense,ARI,699.35,69,6,14,20,1.715879031
20172018,Jason Dickinson,Left Wing,DAL,896.05,27,0,2,2,0.133921098
20172018,Jason Garrison,Defense,VGK,215.8333333,8,0,1,1,0.277992278
20172018,Jason Pominville,Right Wing,BUF,910.4333333,82,16,18,34,2.240691246
20172018,Jason Spezza,Center,DAL,1007.2,78,8,18,26,1.548848292
20172018,Jason Zucker,Left Wing,MIN,1383.783333,82,33,31,64,2.775000903
20172018,Jay Beagle,Right Wing,WSH,776.9,79,7,15,22,1.699060368
20172018,Jay Bouwmeester,Defense,STL,1615.833333,35,2,5,7,0.259927798
20172018,Jaycob Megna,Defense,ANA,406.5,14,0,1,1,0.147601476
20172018,Jayson Megna,Right Wing,VAN,4.3,1,0,0,0,0
20172018,Jean-Gabriel Pageau,Center,OTT,695.8,78,14,15,29,2.500718597
20172018,Jean-Sebastien Dea,Center,PIT,235.8833333,5,1,0,1,0.254363033
20172018,Jeff Carter,Center,LAK,1378.85,27,13,9,22,0.957319505
20172018,Jeff Petry,Defense,MTL,1894.716667,82,12,30,42,1.330014162
20172018,Jeff Skinner,Left Wing,CAR,1519.366667,82,24,25,49,1.935016783
20172018,Jesper Bratt,Left Wing,NJD,772.7,74,13,22,35,2.717742979
20172018,Jesper Fast,Left Wing,NYR,1037.9,71,13,20,33,1.907698237
20172018,Jesse Puljujarvi,Right Wing,EDM,549.35,65,12,8,20,2.184399745
20172018,Jim O'Brien,Center,OTT,87.55,10,0,1,1,0.685322673
20172018,Jimmy Hayes,Right Wing,NJD,392.4166667,33,3,6,9,1.376088341
20172018,Jimmy Vesey,Left Wing,NYR,1300.65,79,17,11,28,1.291661861
20172018,Joakim Nordstrom,Left Wing,CAR,943.1833333,75,2,5,7,0.445300489
20172018,Joakim Ryan,Defense,SJS,562.0666667,62,3,9,12,1.280986834
20172018,Joe Hicketts,Defense,DET,204.45,5,0,3,3,0.880410858
20172018,Joe Morrow,Defense,MTL/WPG,572.2833333,56,6,10,16,1.677490753
20172018,Joe Pavelski,Right Wing,SJS,1442.933333,82,22,44,66,2.744409536
20172018,Joe Thornton,Center,SJS,1137.016667,47,13,23,36,1.899708301
20172018,Joel Armia,Right Wing,WPG,901.0666667,79,12,17,29,1.931044688
20172018,Joel Edmundson,Defense,STL,1239.483333,69,7,10,17,0.82292353
20172018,Joel Eriksson Ek,Center,MIN,783.4833333,75,6,10,16,1.225297283
20172018,Joel Hanley,Defense,ARI,219.0833333,5,0,0,0,0
20172018,Joel Ward,Right Wing,SJS,616.5333333,52,5,7,12,1.167820069
20172018,Johan Larsson,Left Wing,BUF,1043.366667,80,4,13,17,0.977604549
20172018,John Carlson,Defense,WSH,2002.9,82,15,53,68,2.037046283
20172018,John Gilmour,Defense,NYR,80.38333333,28,2,3,5,3.73211694
20172018,John Hayden,Center,CHI,494.7,47,4,9,13,1.576713159
20172018,John Klingberg,Defense,DAL,1567.683333,82,8,59,67,2.564293384
20172018,John Moore,Defense,NJD,1144.783333,81,7,11,18,0.943409961
20172018,John Quenneville,Center,NJD,214.9833333,2,0,0,0,0
20172018,John Tavares,Center,NYI,1565.016667,82,37,47,84,3.220412988
20172018,Johnny Boychuk,Defense,NYI,1394.1,58,6,12,18,0.774693351
20172018,Johnny Gaudreau,Left Wing,CGY,1645.133333,80,24,60,84,3.063581473
20172018,Johnny Oduya,Defense,OTT/PHI,887.9833333,52,4,4,8,0.540550686
20172018,Jon Merrill,Defense,VGK,1018.266667,34,1,2,3,0.176770983
20172018,Jonas Brodin,Defense,MIN,1684.333333,73,6,15,21,0.748070453
20172018,Jonathan Drouin,Left Wing,MTL,1371.85,77,13,33,46,2.011881765
20172018,Jonathan Ericsson,Defense,DET,897.1666667,81,3,10,13,0.869403678
20172018,Jonathan Huberdeau,Left Wing,FLA,1541.233333,82,27,42,69,2.686160434
20172018,Jonathan Marchessault,Right Wing,VGK,1483.166667,77,27,48,75,3.03404877
20172018,Jonathan Toews,Center,CHI,1718.716667,74,20,32,52,1.815307933
20172018,Jonny Brodzinski,Center,LAK,129,35,4,2,6,2.790697674
20172018,Joonas Donskoi,Left Wing,SJS,1074.183333,66,14,18,32,1.787404385
20172018,Jordan Eberle,Right Wing,NYI,1289.766667,81,25,34,59,2.744682501
20172018,Jordan Greenway,Left Wing,MIN,1103.733333,6,0,1,1,0.054360957
20172018,Jordan Martinook,Left Wing,ARI,1187.55,81,6,9,15,0.757862827
20172018,Jordan Nolan,Center,BUF,111.25,69,4,4,8,4.314606742
20172018,Jordan Oesterle,Defense,CHI,1340.633333,55,5,10,15,0.671324498
20172018,Jordan Schmaltz,Defense,STL,229.6166667,13,0,1,1,0.261305074
20172018,Jordan Schroeder,Center,CBJ,156.9666667,21,1,1,2,0.764493523
20172018,Jordan Staal,Center,CAR,914.2,79,19,27,46,3.019033034
20172018,Jordan Szwarz,Right Wing,BOS,138.1166667,12,0,3,3,1.303246048
20172018,Jordan Weal,Center,PHI,848.0666667,69,8,13,21,1.485732254
20172018,Jordie Benn,Defense,MTL,1473.883333,77,4,11,15,0.610631778
20172018,Jori Lehtera,Center,PHI,246,62,3,5,8,1.951219512
20172018,Joseph Blandisi,Center,ANA,67,3,0,0,0,0
20172018,Josh Anderson,Right Wing,CBJ,1395.916667,63,19,11,30,1.289475255
20172018,Josh Archibald,Right Wing,PIT/ARI,922.0833333,42,5,6,11,0.715770447
20172018,Josh Bailey,Left Wing,NYI,1379.166667,76,18,53,71,3.088821752
20172018,Josh Gorges,Defense,BUF,507.6333333,34,0,2,2,0.236391096
20172018,Josh Jooris,Center,CAR/PIT,390.5833333,40,3,3,6,0.921698314
20172018,Josh Leivo,Left Wing,TOR,1066.516667,16,1,3,4,0.225031645
20172018,Josh Manson,Defense,ANA,1651.083333,80,7,30,37,1.344571746
20172018,Josh Morrissey,Defense,WPG,1323.35,81,7,19,26,1.178826463
20172018,Joshua Ho-Sang,Right Wing,NYI,146.0166667,22,2,10,12,4.930943956
20172018,Jujhar Khaira,Left Wing,EDM,754.1166667,69,11,10,21,1.670829005
20172018,Julius Honka,Defense,DAL,397.6833333,42,1,3,4,0.603495243
20172018,Jussi Jokinen,Left Wing,EDM/LAK/CBJ/VAN,694.5166667,60,5,12,17,1.468647261
20172018,Justin Abdelkader,Left Wing,DET,1092.766667,75,13,22,35,1.921727725
20172018,Justin Auger,Right Wing,LAK,15.98333333,2,0,0,0,0
20172018,Justin Bailey,Right Wing,BUF,63.08333333,12,3,1,4,3.804491413
20172018,Justin Braun,Defense,SJS,1582.25,81,5,28,33,1.251382525
20172018,Justin Falk,Defense,BUF,127.7,46,1,1,2,0.939702428
20172018,Justin Faulk,Defense,CAR,1836.35,76,8,23,31,1.012878809
20172018,Justin Holl,Defense,TOR,137.3,2,2,0,2,0.873998543
20172018,Justin Kloos,Right Wing,MIN,7.066666667,1,0,0,0,0
20172018,Justin Schultz,Defense,PIT,594.2166667,63,4,23,27,2.726278294
20172018,Justin Williams,Right Wing,CAR,1430.033333,82,16,35,51,2.139810261
20172018,Kailer Yamamoto,Center,EDM,223,9,0,3,3,0.807174888
20172018,Kalle Kossila,Left Wing,ANA,82.43333333,10,1,1,2,1.455721795
20172018,Karl Alzner,Defense,MTL,155.85,82,1,11,12,4.619826756
20172018,Kasperi Kapanen,Right Wing,TOR,1295.783333,38,7,2,9,0.416736337
20172018,Keegan Lowe,Defense,EDM,27.8,2,0,0,0,0
20172018,Keith Yandle,Defense,FLA,1841.25,82,8,48,56,1.824847251
20172018,Kenny Agostino,Left Wing,BOS,814.3,5,0,1,1,0.073682918
20172018,Kerby Rychel,Left Wing,MTL,18.35,4,1,1,2,6.539509537
20172018,Kevan Miller,Defense,BOS,692.0666667,68,1,15,16,1.3871496
20172018,Kevin Bieksa,Defense,ANA,1060.9,59,0,8,8,0.452446036
20172018,Kevin Connauton,Defense,ARI,916.1333333,73,11,10,21,1.375345656
20172018,Kevin Fiala,Center,NSH,1297.1,80,23,25,48,2.220337676
20172018,Kevin Gravel,Defense,LAK,529.3833333,16,0,3,3,0.34001826
20172018,Kevin Hayes,Right Wing,NYR,1297.866667,76,25,19,44,2.034107253
20172018,Kevin Labanc,Right Wing,SJS,1149.566667,77,11,29,40,2.087743208
20172018,Kevin Rooney,Center,NJD,517.1333333,1,0,0,0,0
20172018,Kevin Roy,Left Wing,ANA,39.13333333,25,6,1,7,10.73253833
20172018,Kevin Shattenkirk,Defense,NYR,1381.916667,46,5,18,23,0.998613037
20172018,Klas Dahlbeck,Defense,CAR,540,33,1,4,5,0.555555556
20172018,Korbinian Holzer,Defense,ANA,353.9166667,16,0,0,0,0
20172018,Kris Letang,Defense,PIT,1686.383333,79,9,42,51,1.814534062
20172018,Kris Russell,Defense,EDM,1467.95,78,4,17,21,0.858339862
20172018,Kris Versteeg,Left Wing,CGY,316.7666667,24,3,5,8,1.515310954
20172018,Kurtis MacDermid,Defense,LAK,102.7833333,34,1,3,4,2.335008918
20172018,Kyle Brodziak,Center,STL,818.35,81,10,23,33,2.419502658
20172018,Kyle Capobianco,Defense,ARI,32.15,1,0,0,0,0
20172018,Kyle Clifford,Left Wing,LAK,754.8666667,50,6,4,10,0.794842356
20172018,Kyle Connor,Center,WPG,1579.116667,76,31,26,57,2.165767782
20172018,Kyle Criscuolo,Center,BUF,72.13333333,9,0,0,0,0
20172018,Kyle Okposo,Right Wing,BUF,1075.533333,76,15,29,44,2.454596169
20172018,Kyle Palmieri,Right Wing,NJD,1342.566667,62,24,20,44,1.966382799
20172018,Kyle Quincey,Defense,MIN,257.9333333,18,0,3,3,0.697854743
20172018,Kyle Rau,Left Wing,MIN,42.08333333,3,0,1,1,1.425742574
20172018,Kyle Turris,Center,OTT/NSH,862.9,76,16,35,51,3.546181481
20172018,Lance Bouma,Left Wing,CHI,564.4166667,53,3,6,9,0.956739997
20172018,Landon Ferraro,Right Wing,MIN,8.833333333,2,1,0,1,6.79245283
20172018,Lars Eller,Center,WSH,1339.066667,81,18,20,38,1.702678483
20172018,Laurent Dauphin,Center,ARI,12.31666667,2,0,0,0,0
20172018,Lawson Crouse,Left Wing,ARI,1047.416667,11,1,0,1,0.057283793
20172018,Lee Stempniak,Right Wing,CAR,15.63333333,37,3,6,9,34.54157783
20172018,Leo Komarov,Center,TOR,1139.133333,74,7,12,19,1.000760812
20172018,Leon Draisaitl,Center,EDM,1849.933333,78,25,45,70,2.270352085
20172018,Liam O'Brien,Center,WSH,20.75,3,0,0,0,0
20172018,Lias Andersson,Center,NYR,450.0833333,7,1,1,2,0.266617293
20172018,Logan Brown,Center,OTT,21.03333333,4,0,1,1,2.852614897
20172018,Logan Couture,Center,SJS,1505.333333,78,34,27,61,2.431355182
20172018,Logan Shaw,Right Wing,ANA/MTL,854.0333333,72,4,10,14,0.983568167
20172018,Loui Eriksson,Right Wing,VAN,1140.483333,50,10,13,23,1.210013298
20172018,Louie Belpedio,Defense,MIN,26.26666667,1,0,2,2,4.568527919
20172018,Luca Sbisa,Defense,VGK,138.6833333,30,2,12,14,6.056964307
20172018,Lucas Wallmark,Center,CAR,1195.416667,11,1,0,1,0.050191704
20172018,Lukas Sedlak,Center,CBJ,422.3833333,53,4,4,8,1.136408476
20172018,Luke Glendening,Center,DET,1232.366667,69,11,8,19,0.925049363
20172018,Luke Kunin,Center,MIN,778.2,19,2,2,4,0.308404009
20172018,Luke Schenn,Defense,ARI,361.75,64,1,6,7,1.161022806
20172018,Luke Witkowski,Defense,DET,326.5666667,31,1,3,4,0.734918853
20172018,MacKenzie Weegar,Defense,FLA,1084.65,60,2,6,8,0.442539068
20172018,Madison Bowey,Defense,WSH,762.9166667,51,0,12,12,0.943746587
20172018,Magnus Paajarvi,Left Wing,STL/OTT,1076.883333,79,8,4,12,0.668596103
20172018,Marc Methot,Defense,DAL,152.4666667,36,1,2,3,1.18058592
20172018,Marc Staal,Defense,NYR,1534.583333,72,1,7,8,0.312788488
20172018,Marc-Edouard Vlasic,Defense,SJS,1520.416667,81,11,21,32,1.262811729
20172018,Marco Scandella,Defense,BUF,1109.45,82,5,17,22,1.189778719
20172018,Marcus Foligno,Left Wing,MIN,980.4166667,77,8,15,23,1.407564811
20172018,Marcus Johansson,Left Wing,NJD,923.6166667,29,5,9,14,0.909468214
20172018,Marcus Kruger,Center,CAR,773.0666667,48,1,5,6,0.46567782
20172018,Marcus Pettersson,Defense,ANA,1402.85,22,1,3,4,0.171080301
20172018,Marcus Sorensen,Left Wing,SJS,1038.4,32,5,2,7,0.404468413
20172018,Marek Hrivik,Left Wing,CGY,24.56666667,3,0,0,0,0
20172018,Marian Gaborik,Right Wing,LAK/OTT,642.3333333,46,11,10,21,1.961598339
20172018,Mario Kempe,Left Wing,ARI,581.1833333,18,2,2,4,0.412950589
20172018,Mark Alt,Defense,PHI/COL,19.81666667,15,0,0,0,0
20172018,Mark Barberio,Defense,COL,182.8,46,3,10,13,4.266958425
20172018,Mark Borowiecki,Defense,OTT,826.7833333,52,3,8,11,0.798274437
20172018,Mark Giordano,Defense,CGY,1890.966667,82,13,25,38,1.205732518
20172018,Mark Jankowski,Center,CGY,1004.2,72,17,8,25,1.493726349
20172018,Mark Letestu,Center,EDM/CBJ,18.08333333,80,9,14,23,76.31336406
20172018,Mark Pysyk,Defense,FLA,1277.883333,82,3,13,16,0.751242289
20172018,Mark Scheifele,Center,WPG,1794.083333,60,23,37,60,2.006595755
20172018,Mark Stone,Right Wing,OTT,1530.5,58,20,42,62,2.430578242
20172018,Mark Streit,Defense,MTL,28.43333333,2,0,0,0,0
20172018,Marko Dano,Left Wing,WPG,55.06666667,23,2,1,3,3.268765133
20172018,Markus Granlund,Center,VAN,1157.5,53,8,4,12,0.622030238
20172018,Markus Hannikainen,Left Wing,CBJ,416.6833333,33,3,3,6,0.863965441
20172018,Markus Nutivaara,Defense,CBJ,1414.883333,61,7,16,23,0.975345435
20172018,Martin Frk,Right Wing,DET,276.6666667,68,11,14,25,5.421686747
20172018,Martin Hanzal,Center,DAL,90.05,38,5,5,10,6.662965019
20172018,Martin Marincin,Defense,TOR,365.0333333,2,0,0,0,0
20172018,Martin Necas,Center,CAR,70.16666667,1,0,0,0,0
20172018,Mathew Barzal,Center,NYI,1469.583333,82,22,63,85,3.47037142
20172018,Mathieu Perreault,Center,WPG,1003.666667,70,17,22,39,2.331451345
20172018,Mats Zuccarello,Left Wing,NYR,952.7833333,80,16,37,53,3.337589868
20172018,Matt Bartkowski,Defense,CGY,21.4,18,0,3,3,8.411214953
20172018,Matt Beleskey,Left Wing,BOS/NYR,29.48333333,15,0,0,0,0
20172018,Matt Calvert,Left Wing,CBJ,1162.533333,69,9,15,24,1.23867416
20172018,Matt Cullen,Center,MIN,817.5333333,79,11,11,22,1.614613064
20172018,Matt Duchene,Center,COL/OTT,1373.083333,82,27,32,59,2.578139224
20172018,Matt Dumba,Defense,MIN,748.05,82,14,36,50,4.01042711
20172018,Matt Grzelcyk,Defense,BOS,1262.033333,61,3,12,15,0.713134888
20172018,Matt Hendricks,Left Wing,WPG,229.85,60,5,8,13,3.393517511
20172018,Matt Hunwick,Defense,PIT,219.55,42,4,6,10,2.732862674
20172018,Matt Irwin,Defense,NSH,497.1,50,2,6,8,0.965600483
20172018,Matt Martin,Left Wing,TOR,766.25,50,3,9,12,0.939641109
20172018,Matt Moulson,Left Wing,BUF,144.0166667,14,0,0,0,0
20172018,Matt Nieto,Left Wing,COL,879.45,74,15,11,26,1.77383592
20172018,Matt Niskanen,Defense,WSH,1754.533333,68,7,22,29,0.991716696
20172018,Matt Read,Right Wing,PHI,141.05,19,1,0,1,0.425381071
20172018,Matt Stajan,Center,CGY,743.45,68,4,8,12,0.968457865
20172018,Matt Tennyson,Defense,BUF,42.98333333,15,0,0,0,0
20172018,Matthew Benning,Defense,EDM,1046,73,6,15,21,1.20458891
20172018,Matthew Highmore,Left Wing,CHI,157.95,13,2,0,2,0.759734093
20172018,Matthew Peca,Center,TBL,411.2333333,10,2,3,5,0.729512848
20172018,Matthew Tkachuk,Left Wing,CGY,1406.55,68,24,25,49,2.090220753
20172018,Mattias Ekholm,Defense,NSH,1869.883333,81,10,24,34,1.090977155
20172018,Mattias Janmark,Center,DAL,1232.65,81,19,15,34,1.654970997
20172018,Max Domi,Left Wing,ARI,1425.4,82,9,36,45,1.894205135
20172018,Max McCormick,Left Wing,OTT,104.9333333,30,3,2,5,2.858958069
20172018,Max Pacioretty,Left Wing,MTL,1122.483333,64,17,20,37,1.97775765
20172018,Maxim Mamin,Left Wing,FLA,52.33333333,26,3,1,4,4.585987261
20172018,Melker Karlsson,Center,SJS,907.9666667,71,8,11,19,1.2555527
20172018,Michael Amadio,Center,LAK,438.9333333,37,4,4,8,1.093560146
20172018,Michael Bournival,Left Wing,TBL,46.73333333,5,0,0,0,0
20172018,Michael Chaput,Center,VAN,359.1333333,9,0,0,0,0
20172018,Michael Dal Colle,Left Wing,NYI,339.0666667,4,0,0,0,0
20172018,Michael Del Zotto,Defense,VAN,715.8166667,82,6,16,22,1.844047591
20172018,Michael Frolik,Right Wing,CGY,867.9333333,70,10,15,25,1.728243337
20172018,Michael Grabner,Right Wing,NYR/NJD,589.6666667,80,27,9,36,3.66308649
20172018,Michael Matheson,Defense,FLA,1673.95,81,10,17,27,0.967770841
20172018,Michael McCarron,Right Wing,MTL,158.0833333,18,0,1,1,0.379546653
20172018,Michael Raffl,Left Wing,PHI,764.8333333,76,13,9,22,1.725866202
20172018,Michael Stone,Defense,CGY,223.1,82,3,7,10,2.689376961
20172018,Michal Kempny,Defense,CHI/WSH,1362.266667,53,3,7,10,0.4404424
20172018,Micheal Ferland,Left Wing,CGY,997.8,77,21,20,41,2.465423933
20172018,Micheal Haley,Center,FLA,347.9,75,3,6,9,1.552170164
20172018,Miikka Salomaki,Right Wing,NSH,387.8333333,58,2,6,8,1.237645037
20172018,Mika Zibanejad,Center,NYR,1685.4,72,27,20,47,1.673193307
20172018,Mikael Backlund,Center,CGY,1377.733333,82,14,31,45,1.959740637
20172018,Mikael Granlund,Center,MIN,1449.983333,77,21,46,67,2.77244566
20172018,Mike Blunden,Right Wing,OTT,6.516666667,1,0,0,0,0
20172018,Mike Cammalleri,Left Wing,LAK/EDM,907.6333333,66,7,22,29,1.917073708
20172018,Mike Fisher,Center,NSH,197.8666667,16,2,2,4,1.212938005
20172018,Mike Green,Defense,DET,930.25,66,8,25,33,2.128460091
20172018,Mike Hoffman,Left Wing,OTT,1462.066667,82,22,34,56,2.298116821
20172018,Mike Liambas,Left Wing,ANA,37.01666667,7,0,1,1,1.62089149
20172018,Mike Reilly,Defense,MIN/MTL,1064.533333,57,2,16,18,1.014529058
20172018,Mikhail Sergachev,Defense,TBL,1342.616667,79,9,31,40,1.787554154
20172018,Mikkel Boedker,Left Wing,SJS,996.3166667,74,15,22,37,2.22820723
20172018,Mikko Koivu,Center,MIN,879.1166667,82,14,31,45,3.071264716
20172018,Mikko Rantanen,Right Wing,COL,1542.233333,81,29,55,84,3.267987983
20172018,Milan Lucic,Left Wing,EDM,1044.85,82,10,24,34,1.952433364
20172018,Miles Wood,Left Wing,NJD,863.8666667,76,19,13,32,2.222565211
20172018,Mirco Mueller,Defense,NJD,957.9166667,28,0,4,4,0.250543715
20172018,Mitch Marner,Center,TOR,1625.316667,82,22,47,69,2.547195931
20172018,Mitch Reinke,Defense,STL,13.03333333,1,0,0,0,0
20172018,Morgan Klimchuk,Left Wing,CGY,7.416666667,1,0,0,0,0
20172018,Morgan Rielly,Defense,TOR,1895.95,76,6,46,52,1.645613017
20172018,Nail Yakupov,Right Wing,COL,628.95,58,9,7,16,1.526353446
20172018,Nate Prosser,Defense,STL/MIN,152.95,57,3,6,9,3.530565544
20172018,Nate Schmidt,Defense,VGK,1338.366667,76,5,31,36,1.613907499
20172018,Nate Thompson,Center,OTT/LAK,1013.666667,69,5,12,17,1.006247945
20172018,Nathan Beaulieu,Defense,BUF,744.2666667,59,1,8,9,0.725546399
20172018,Nathan Gerbe,Center,CBJ,17.2,2,0,0,0,0
20172018,Nathan MacKinnon,Center,COL,1810.7,74,39,58,97,3.214226542
20172018,Nathan Walker,Left Wing,WSH/EDM,24.43333333,9,1,0,1,2.455661664
20172018,Nazem Kadri,Center,TOR,1181.966667,80,32,23,55,2.791956908
20172018,Neal Pionk,Defense,NYR,1546.25,28,1,13,14,0.543249798
20172018,Nic Dowd,Center,LAK/VAN,658.4666667,56,3,1,4,0.364483143
20172018,Nic Petan,Center,WPG,137.1333333,15,2,0,2,0.875060768
20172018,Nicholas Baptiste,Right Wing,BUF,329.5666667,33,4,2,6,1.092343481
20172018,Nick Bjugstad,Center,FLA,969.3166667,82,19,30,49,3.03306453
20172018,Nick Bonino,Center,NSH,1320.416667,71,12,13,25,1.136005049
20172018,Nick Cousins,Center,ARI,1099.35,71,12,7,19,1.036976395
20172018,Nick Foligno,Left Wing,CBJ,1292.116667,72,15,18,33,1.532369368
20172018,Nick Holden,Defense,NYR/BOS,1117.316667,73,4,13,17,0.912901445
20172018,Nick Jensen,Defense,DET,1584.466667,81,0,15,15,0.568014474
20172018,Nick Lappin,Center,NJD,150.6666667,6,1,0,1,0.398230088
20172018,Nick Leddy,Defense,NYI,1765.316667,80,10,32,42,1.427505924
20172018,Nick Merkley,Center,ARI,13.5,1,0,0,0,0
20172018,Nick Paul,Center,OTT,169.4833333,11,1,0,1,0.354017111
20172018,Nick Ritchie,Left Wing,ANA,898.4333333,76,10,17,27,1.803138797
20172018,Nick Schmaltz,Center,CHI,714.25,78,21,31,52,4.368218411
20172018,Nick Seeler,Defense,MIN,875.55,22,0,4,4,0.274113414
20172018,Nick Shore,Center,LAK/OTT/CGY,906.35,64,5,14,19,1.257792244
20172018,Nicklas Backstrom,Center,WSH,1596.433333,81,21,50,71,2.668448416
20172018,Nico Hischier,Center,NJD,1249.883333,82,20,32,52,2.496232982
20172018,Nicolas Deslauriers,Left Wing,MTL,481.8166667,58,10,4,14,1.743401709
20172018,Nicolas Kerdiles,Left Wing,ANA,7.066666667,2,0,0,0,0
20172018,Nicolas Roy,Center,CAR,41.7,1,0,0,0,0
20172018,Nikita Kucherov,Right Wing,TBL,1637.4,80,39,61,100,3.664345914
20172018,Nikita Scherbak,Left Wing,MTL,81.41666667,26,4,2,6,4.421699079
20172018,Nikita Soshnikov,Left Wing,TOR/STL,35.93333333,15,1,1,2,3.339517625
20172018,Nikita Zadorov,Defense,COL,1203.616667,77,7,13,20,0.996995167
20172018,Nikita Zaitsev,Defense,TOR,1660.316667,60,5,8,13,0.4697899
20172018,Niklas Hjalmarsson,Defense,ARI,1616.616667,48,1,8,9,0.334030949
20172018,Niklas Kronwall,Defense,DET,1578.516667,79,4,23,27,1.026279946
20172018,Nikolaj Ehlers,Left Wing,WPG,978.5,82,29,31,60,3.679100664
20172018,Nikolay Goldobin,Right Wing,VAN,945.2333333,38,8,6,14,0.888669464
20172018,Nikolay Kulemin,Left Wing,NYI,155.1833333,13,1,2,3,1.159918376
20172018,Nino Niederreiter,Right Wing,MIN,1332.083333,63,18,14,32,1.441351267
20172018,Noah Hanifin,Defense,CAR,1659.333333,79,10,22,32,1.157091201
20172018,Noah Juulsen,Defense,MTL,359.4166667,23,1,2,3,0.5008115
20172018,Noel Acciari,Center,BOS,935.5833333,60,10,1,11,0.705442237
20172018,Nolan Patrick,Center,PHI,1086.016667,73,13,17,30,1.657433127
20172018,Oliver Bjorkstrand,Right Wing,CBJ,950.6166667,82,11,29,40,2.524676964
20172018,Oliver Ekman-Larsson,Defense,ARI,1914.2,82,14,28,42,1.316476857
20172018,Olli Maatta,Defense,PIT,1114.066667,82,7,22,29,1.561845491
20172018,Ondrej Kase,Right Wing,ANA,470.2166667,66,20,18,38,4.848828554
20172018,Ondrej Palat,Left Wing,TBL,951.9333333,56,11,24,35,2.206036837
20172018,Oscar Fantenberg,Defense,LAK,976.2833333,27,2,7,9,0.553118118
20172018,Oscar Klefbom,Defense,EDM,1462.983333,66,5,16,21,0.861253831
20172018,Oscar Lindberg,Center,VGK,685.3666667,63,9,2,11,0.962988182
20172018,Oskar Lindblom,Left Wing,PHI,1113.716667,23,2,4,6,0.323241998
20172018,Oskar Sundqvist,Center,STL,1026.366667,42,1,4,5,0.292293203
20172018,Owen Tippett,Right Wing,FLA,79.31666667,7,1,0,1,0.756461441
20172018,P.K. Subban,Defense,NSH,1426.816667,82,16,43,59,2.481047553
20172018,Patric Hornqvist,Right Wing,PIT,1067.033333,70,29,20,49,2.755302865
20172018,Patrice Bergeron,Center,BOS,1199.433333,64,30,33,63,3.151488203
20172018,Patrick Eaves,Right Wing,ANA,97.18333333,2,1,0,1,0.617389813
20172018,Patrick Kane,Right Wing,CHI,1819.466667,82,27,49,76,2.506228932
20172018,Patrick Marleau,Left Wing,TOR,1340.033333,82,27,20,47,2.104425263
20172018,Patrick Maroon,Left Wing,EDM/NJD,1049.433333,74,17,26,43,2.45846965
20172018,Patrick Sharp,Left Wing,CHI,900.1666667,70,10,11,21,1.399740789
20172018,Patrick Sieloff,Defense,OTT,11.18333333,1,1,0,1,5.365126677
20172018,Patrik Berglund,Center,STL,299.9833333,57,17,9,26,5.200288905
20172018,Patrik Laine,Right Wing,WPG,1412.883333,82,44,26,70,2.972644592
20172018,Patrik Nemeth,Defense,COL,1219.533333,68,3,12,15,0.737987208
20172018,Paul Byron,Left Wing,MTL,814.5166667,82,20,15,35,2.57821612
20172018,Paul Carey,Left Wing,NYR,74.5,60,7,7,14,11.27516779
20172018,Paul LaDue,Defense,LAK,435.4833333,12,3,1,4,0.551111791
20172018,Paul Martin,Defense,SJS,206.65,14,0,2,2,0.580691991
20172018,Paul Postma,Defense,BOS,142.95,14,0,1,1,0.419727177
20172018,Paul Stastny,Center,STL/WPG,904.0333333,82,16,37,53,3.517569411
20172018,Pavel Buchnevich,Left Wing,NYR,971.1666667,74,14,29,43,2.656598593
20172018,Pavel Zacha,Left Wing,NJD,978.9,69,8,17,25,1.53233221
20172018,Peter Cehlarik,Left Wing,BOS,251.65,6,1,1,2,0.476852772
20172018,Peter Holland,Center,NYR,285.5,23,1,3,4,0.840630473
20172018,Phil Kessel,Right Wing,PIT,1472.066667,82,34,58,92,3.749830171
20172018,Philip Holm,Defense,VAN,14.85,1,0,0,0,0
20172018,Phillip Danault,Center,MTL,1439.083333,52,8,17,25,1.042330187
20172018,Phillip Di Giuseppe,Left Wing,CAR,243.3833333,49,5,8,13,3.204820927
20172018,Pierre-Edouard Bellemare,Left Wing,VGK,943.9833333,72,6,10,16,1.016967107
20172018,Pierre-Luc Dubois,Left Wing,CBJ,1452.5,82,20,28,48,1.982788296
20172018,Pontus Aberg,Right Wing,NSH/EDM,860.6833333,53,4,12,16,1.115392808
20172018,Radek Faksa,Center,DAL,1330.416667,79,17,16,33,1.488255559
20172018,Radim Vrbata,Right Wing,FLA,542.6333333,42,5,9,14,1.548006634
20172018,Radko Gudas,Defense,PHI,1376.4,70,2,14,16,0.697471665
20172018,Rasmus Andersson,Defense,CGY,1265.75,10,0,0,0,0
20172018,Rasmus Ristolainen,Defense,BUF,1922.2,73,6,35,41,1.279783581
20172018,Reid Boucher,Left Wing,VAN,5.466666667,20,3,2,5,54.87804878
20172018,Reilly Smith,Right Wing,VGK,1349.633333,67,22,38,60,2.667391143
20172018,Remi Elie,Left Wing,DAL,165.6,72,6,8,14,5.072463768
20172018,Richard Panik,Right Wing,CHI/ARI,1245.716667,72,14,21,35,1.685776594
20172018,Rick Nash,Left Wing,NYR/BOS,1206.883333,71,21,13,34,1.690304227
20172018,Rickard Rakell,Right Wing,ANA,1276.25,77,34,35,69,3.24387855
20172018,Riley Nash,Center,BOS,844.9333333,76,15,26,41,2.911472306
20172018,Riley Sheahan,Center,DET/PIT,1103.566667,81,11,21,32,1.739813333
20172018,Rinat Valiev,Defense,MTL,23.65,2,0,0,0,0
20172018,Rob O'Gara,Defense,BOS/NYR,465.1166667,30,0,3,3,0.386999678
20172018,Robert Bortuzzo,Defense,STL,913.8,72,4,9,13,0.853578464
20172018,Robert Hagg,Defense,PHI,1389.083333,70,3,6,9,0.388745576
20172018,Rocco Grimaldi,Right Wing,COL,531.0333333,6,1,2,3,0.338961773
20172018,Roland McKeown,Defense,CAR,133.4166667,10,0,3,3,1.349156777
20172018,Roman Josi,Defense,NSH,2060.866667,75,14,39,53,1.543040145
20172018,Roman Polak,Defense,TOR,1474.866667,54,2,10,12,0.488179722
20172018,Ron Hainsey,Defense,TOR,1640.233333,80,4,19,23,0.841343711
20172018,Ross Johnston,Left Wing,NYI,134.5166667,24,3,3,6,2.676248296
20172018,Ryan Callahan,Right Wing,TBL,579.2166667,67,5,13,18,1.86458723
20172018,Ryan Carpenter,Center,SJS/VGK,856.8333333,52,9,6,15,1.050379304
20172018,Ryan Donato,Center,BOS,767.1166667,12,5,4,9,0.703934647
20172018,Ryan Dzingel,Center,OTT,1310.6,79,23,18,41,1.877002899
20172018,Ryan Ellis,Defense,NSH,1967.566667,44,9,23,32,0.975824623
20172018,Ryan Getzlaf,Center,ANA,1304.683333,56,11,50,61,2.80527842
20172018,Ryan Hartman,Right Wing,CHI/NSH,1089.05,78,11,20,31,1.707910564
20172018,Ryan Johansen,Center,NSH,1563.933333,79,15,39,54,2.071699561
20172018,Ryan Kesler,Center,ANA,990.05,44,8,6,14,0.848441998
20172018,Ryan Lomberg,Left Wing,CGY,27.93333333,7,0,1,1,2.14797136
20172018,Ryan McDonagh,Defense,NYR/TBL,1811.983333,63,4,25,29,0.960273733
20172018,Ryan Murphy,Defense,MIN,33.46666667,21,2,3,5,8.964143426
20172018,Ryan Murray,Defense,CBJ,1200.433333,44,1,11,12,0.599783412
20172018,Ryan Nugent-Hopkins,Center,EDM,1647.8,62,24,24,48,1.747784925
20172018,Ryan O'Reilly,Center,BUF,1700.7,81,24,37,61,2.152055036
20172018,Ryan Pulock,Defense,NYI,1833.5,68,10,22,32,1.047177529
20172018,Ryan Reaves,Right Wing,PIT/VGK,867.6833333,79,4,6,10,0.691496514
20172018,Ryan Spooner,Center,BOS/NYR,594.2833333,59,13,28,41,4.139439661
20172018,Ryan Sproul,Defense,NYR,262.4666667,16,1,4,5,1.143002286
20172018,Ryan Strome,Center,EDM,1262.433333,82,13,21,34,1.615926914
20172018,Ryan Suter,Defense,MIN,2188.883333,78,6,45,51,1.397973091
20172018,Sam Bennett,Center,CGY,944.2333333,82,11,15,26,1.652134006
20172018,Sam Gagner,Center,VAN,463.9333333,74,10,21,31,4.009196724
20172018,Sam Reinhart,Right Wing,BUF,1555.066667,82,25,25,50,1.929177742
20172018,Sami Niku,Defense,WPG,417.2833333,1,1,0,1,0.143787195
20172018,Sami Vatanen,Defense,ANA/NJD,1084.616667,72,4,28,32,1.770210674
20172018,Samuel Blais,Left Wing,STL,314.5333333,11,1,2,3,0.572276388
20172018,Samuel Girard,Defense,NSH/COL,1631.983333,73,4,19,23,0.845596871
20172018,Samuel Morin,Defense,PHI,61.85,2,0,0,0,0
20172018,Scott Harrington,Defense,CBJ,952.55,32,2,3,5,0.314944097
20172018,Scott Hartnell,Left Wing,NSH,744.7833333,62,13,11,24,1.933448206
20172018,Scott Laughton,Center,PHI,1217.8,81,10,10,20,0.985383478
20172018,Scott Mayfield,Defense,NYI,1479.733333,47,2,10,12,0.486574158
20172018,Scott Wilson,Left Wing,PIT/DET/BUF,170.9666667,69,6,8,14,4.913238448
20172018,Scottie Upshall,Left Wing,STL,683.3833333,63,7,12,19,1.668170622
20172018,Sean Couturier,Center,PHI,1769.883333,82,31,45,76,2.576441008
20172018,Sean Kuraly,Center,BOS,977.8833333,75,6,8,14,0.858998176
20172018,Sean Monahan,Center,CGY,1484.75,74,31,33,64,2.586293989
20172018,Seb Aho,Defense,NYI,358.2333333,22,1,3,4,0.669954406
20172018,Sebastian Aho,Center,CAR,1652.983333,78,29,36,65,2.359370431
20172018,Seth Griffith,Center,BUF,222.6166667,21,2,1,3,0.808564797
20172018,Seth Jones,Defense,CBJ,1936.466667,78,16,41,57,1.766103212
20172018,Shane Gersich,Center,WSH,27.05,3,0,1,1,2.218114603
20172018,Shane Prince,Center,NYI,168.0333333,14,1,1,2,0.714144019
20172018,Shawn Matthias,Center,WPG,301.6666667,27,1,2,3,0.596685083
20172018,Shayne Gostisbehere,Defense,PHI,1533.516667,78,13,52,65,2.543174186
20172018,Shea Theodore,Defense,VGK,1586.016667,61,6,23,29,1.097088093
20172018,Shea Weber,Defense,MTL,1359.066667,26,6,10,16,0.706367115
20172018,Sidney Crosby,Center,PIT,1657.866667,82,29,60,89,3.221006917
20172018,Slater Koekkoek,Defense,TBL,490.3333333,35,4,4,8,0.978925901
20172018,Sonny Milano,Left Wing,CBJ,66.56666667,55,14,8,22,19.82974462
20172018,Spencer Foo,Right Wing,CGY,63.8,4,2,0,2,1.880877743
20172018,Stefan Matteau,Left Wing,VGK,64.65,8,0,1,1,0.928074246
20172018,Stefan Noesen,Right Wing,NJD,522.0166667,72,13,14,27,3.103349191
20172018,Stephen Johns,Defense,DAL,1313.4,75,8,7,15,0.685244404
20172018,Steve Bernier,Right Wing,NYI,40.55,4,0,0,0,0
20172018,Steven Fogarty,Center,NYR,77.6,1,0,0,0,0
20172018,Steven Kampfer,Defense,NYR,512.8833333,22,0,1,1,0.116985669
20172018,Steven Santini,Defense,NJD,648.7,36,2,8,10,0.924926777
20172018,Steven Stamkos,Center,TBL,1500.216667,78,27,59,86,3.439503183
20172018,Sven Andrighetto,Right Wing,COL,708.5,50,8,14,22,1.863091037
20172018,Sven Baertschi,Left Wing,VAN,392.6833333,53,14,15,29,4.431051314
20172018,T.J. Oshie,Right Wing,WSH,1284.516667,74,18,29,47,2.195378288
20172018,Tage Thompson,Center,STL,788.25,41,3,6,9,0.685061846
20172018,Tanner Fritz,Center,NYI,86.58333333,34,3,4,7,4.850818094
20172018,Tanner Glass,Left Wing,CGY,150.0833333,16,0,0,0,0
20172018,Tanner Kero,Left Wing,CHI,91.5,8,1,2,3,1.967213115
20172018,Tanner Pearson,Left Wing,LAK,1124.366667,82,15,25,40,2.134534997
20172018,Taylor Chorney,Defense,WSH/CBJ,329.8166667,25,1,3,4,0.727676992
20172018,Taylor Fedun,Defense,BUF,749.5,7,0,1,1,0.080053369
20172018,Taylor Hall,Left Wing,NJD,649.6333333,76,39,54,93,8.589460721
20172018,Taylor Leier,Left Wing,PHI,409.0666667,39,1,4,5,0.733376793
20172018,Teuvo Teravainen,Center,CAR,1467.05,82,23,41,64,2.617497699
20172018,Thomas Chabot,Defense,OTT,1698.733333,63,9,16,25,0.883010871
20172018,Thomas Hickey,Defense,NYI,740.6666667,69,5,20,25,2.02520252
20172018,Thomas Vanek,Right Wing,VAN/CBJ,900.95,80,24,32,56,3.729396748
20172018,Tim Heed,Defense,SJS,532.5166667,29,3,8,11,1.239397828
20172018,Tim Schaller,Center,BOS,500.7,82,12,10,22,2.636309167
20172018,Timo Meier,Right Wing,SJS,1324.7,81,21,15,36,1.630557862
20172018,TJ Brodie,Defense,CGY,1697.083333,73,4,28,32,1.131352811
20172018,Tobias Rieder,Right Wing,ARI/LAK,846.9,78,12,13,25,1.771165427
20172018,Toby Enstrom,Defense,WPG,732.4,43,1,5,6,0.491534681
20172018,Tom Kuhnhackl,Right Wing,PIT,456.55,69,2,6,8,1.051363487
20172018,Tom Pyatt,Center,OTT,433.4,81,7,15,22,3.045685279
20172018,Tom Wilson,Right Wing,WSH,1142.883333,78,14,21,35,1.837457892
20172018,Tomas Hertl,Center,SJS,1462.9,79,22,24,46,1.886663477
20172018,Tomas Hyka,Right Wing,VGK,199.2333333,10,1,2,3,0.903463276
20172018,Tomas Jurco,Right Wing,CHI,365.9,29,6,4,10,1.639792293
20172018,Tomas Nosek,Left Wing,VGK,848.75,67,7,8,15,1.060382916
20172018,Tomas Plekanec,Center,MTL/TOR,32.63333333,77,6,20,26,47.80388151
20172018,Tomas Tatar,Left Wing,DET/VGK,1312.033333,82,20,14,34,1.554838546
20172018,Tommy Wingels,Center,CHI/BOS,860.5333333,75,9,8,17,1.185311435
20172018,Torey Krug,Defense,BOS,1362.65,76,14,45,59,2.597879133
20172018,Torrey Mitchell,Center,MTL/LAK,683.45,60,6,5,11,0.965688785
20172018,Travis Boyd,Center,WSH,520.9,8,0,1,1,0.115185256
20172018,Travis Dermott,Defense,TOR,1106.966667,37,1,12,13,0.704628263
20172018,Travis Hamonic,Defense,CGY,1439.533333,74,1,10,11,0.458481915
20172018,Travis Konecny,Center,PHI,1251.8,81,24,23,47,2.252756031
20172018,Travis Sanheim,Defense,PHI,1602.683333,49,2,8,10,0.374372147
20172018,Travis Zajac,Center,NJD,1542.616667,63,12,14,26,1.011268732
20172018,Trevor Carrick,Defense,CAR,11.48333333,1,0,0,0,0
20172018,Trevor Daley,Defense,DET,817.3833333,77,9,7,16,1.174479538
20172018,Trevor Lewis,Center,LAK,616.5833333,68,14,12,26,2.530071631
20172018,Trevor Murphy,Defense,ARI,113.4666667,8,1,2,3,1.586368978
20172018,Trevor Van Riemsdyk,Defense,CAR,1171.533333,79,3,13,16,0.819438912
20172018,Troy Brouwer,Right Wing,CGY,951.8,76,6,16,22,1.386845976
20172018,Troy Stecher,Defense,VAN,1553.616667,68,1,10,11,0.424815216
20172018,Troy Terry,Right Wing,ANA,446.2833333,2,0,0,0,0
20172018,Tucker Poolman,Defense,WPG,301.5166667,24,1,1,2,0.39798795
20172018,Ty Rattie,Right Wing,EDM,567.3166667,14,5,4,9,0.951849349
20172018,Tyler Bertuzzi,Left Wing,DET,1206.05,48,7,17,24,1.193980349
20172018,Tyler Bozak,Center,TOR,1178.966667,81,11,32,43,2.188357036
20172018,Tyler Ennis,Left Wing,MIN,506.7666667,73,8,14,22,2.604749063
20172018,Tyler Graovac,Center,WSH,33.63333333,5,0,0,0,0
20172018,Tyler Johnson,Center,TBL,1276.383333,81,21,29,50,2.350391079
20172018,Tyler Motte,Center,CBJ/VAN,945.2166667,46,5,2,7,0.444342567
20172018,Tyler Myers,Defense,WPG,1626.966667,82,6,30,36,1.327624004
20172018,Tyler Pitlick,Right Wing,DAL,628.9166667,80,14,13,27,2.575857957
20172018,Tyler Seguin,Center,DAL,1700.95,82,40,38,78,2.751403627
20172018,Tyler Toffoli,Right Wing,LAK,1409.283333,82,24,23,47,2.001017065
20172018,Tyrell Goulbourne,Left Wing,PHI,14.81666667,9,0,0,0,0
20172018,Tyson Barrie,Defense,COL,1699.716667,68,14,43,57,2.012100056
20172018,Tyson Jost,Center,COL,911.2833333,65,12,10,22,1.448506685
20172018,Vadim Shipachyov,Center,VGK,31.56666667,3,1,0,1,1.900739176
20172018,Valentin Zykov,Left Wing,CAR,279.2666667,10,3,4,7,1.503938888
20172018,Valtteri Filppula,Center,PHI,1028.95,81,11,22,33,1.924291754
20172018,Victor Ejdsell,Center,CHI,79.9,6,0,1,1,0.750938673
20172018,Victor Hedman,Defense,TBL,1592.85,77,17,46,63,2.373104812
20172018,Victor Mete,Defense,MTL,1261.55,49,0,7,7,0.332923784
20172018,Victor Rask,Center,CAR,591.8833333,71,14,17,31,3.142511193
20172018,Viktor Antipin,Defense,BUF,717.0333333,47,0,10,10,0.836781182
20172018,Viktor Arvidsson,Right Wing,NSH,1110.4,78,29,32,61,3.29610951
20172018,Vince Dunn,Defense,STL,1366.283333,75,5,19,24,1.053954158
20172018,Vincent Trocheck,Center,FLA,1080.9,82,31,44,75,4.163197336
20172018,Vinni Lettieri,Right Wing,NYR,274.2,19,1,4,5,1.094091904
20172018,Vinnie Hinostroza,Center,CHI,1099.066667,50,7,18,25,1.364794371
20172018,Vladimir Sobotka,Left Wing,STL,979.7833333,81,11,20,31,1.898378893
20172018,Vladimir Tarasenko,Right Wing,STL,1395.316667,80,33,33,66,2.838065433
20172018,Vladislav Kamenev,Left Wing,COL,207.8,3,0,0,0,0
20172018,Vladislav Namestnikov,Center,TBL/NYR,1231.05,81,22,26,48,2.339466309
20172018,Wade Megan,Center,STL,86.65,1,0,0,0,0
20172018,Warren Foegele,Left Wing,CAR,963.0833333,2,2,1,3,0.186899714
20172018,Wayne Simmonds,Right Wing,PHI,1236.95,75,24,22,46,2.231294717
20172018,Will Butcher,Defense,NJD,1503.616667,81,5,39,44,1.755766652
20172018,Will O'Neill,Defense,PHI,9.416666667,1,0,0,0,0
20172018,William Carrier,Center,VGK,536.25,37,1,2,3,0.335664336
20172018,William Karlsson,Center,VGK,1540.683333,82,43,35,78,3.03761318
20172018,William Nylander,Center,TOR,837.7166667,82,20,41,61,4.36901896
20172018,Xavier Ouellet,Defense,DET,323.0666667,45,0,7,7,1.300041271
20172018,Yanni Gourde,Center,TBL,1266.783333,82,25,39,64,3.031299749
20172018,Yannick Weber,Defense,NSH,738.1,47,2,3,5,0.406448991
20172018,Yohann Auvitu,Defense,EDM,447.2833333,33,3,6,9,1.207288445
20172018,Zac Dalpe,Center,CBJ,9.016666667,12,0,0,0,0
20172018,Zac Rinaldo,Center,ARI,163.8666667,53,5,2,7,2.563059398
20172018,Zach Aston-Reese,Right Wing,PIT,586.8666667,16,4,2,6,0.613427241
20172018,Zach Bogosian,Defense,BUF,1405.75,18,0,1,1,0.042681842
20172018,Zach Hyman,Right Wing,TOR,1225.516667,82,15,25,40,1.958357699
20172018,Zach Parise,Left Wing,MIN,1381,42,15,9,24,1.042722665
20172018,Zach Redmond,Defense,BUF,43.43333333,3,0,0,0,0
20172018,Zach Trotman,Defense,PIT,198.45,3,0,0,0,0
20172018,Zach Werenski,Defense,CBJ,1878.316667,77,16,21,37,1.181909334
20172018,Zach Whitecloud,Defense,VGK,16.7,1,0,0,0,0
20172018,Zack Kassian,Right Wing,EDM,1169.3,74,7,12,19,0.974942273
20172018,Zack Mitchell,Right Wing,MIN,242.4166667,23,3,2,5,1.237538673
20172018,Zack Smith,Center,OTT,1144.65,68,5,14,19,0.995937623
20172018,Zdeno Chara,Defense,BOS,1305.233333,73,7,17,24,1.103251015
20172018,Zemgus Girgensons,Center,BUF,980.0166667,71,7,8,15,0.918351729